++++++++++++++++++++
++++++++++++++++++++
++++++++++         +
+++++++            +
+++++        ++++  +
+++++   ++   ++++  +
+++   ++++ 0 ++++  +
+++   +++++     +  +
+++  +++++++       +
+++++++++  ++++    +
++++++++     a     +
++++++++           +
+++++  +++         +
+++++              +
+++++         A    +
+++++  +++  ++  +  +
+++++ ++++  ++  +  +
++++++++++  ++  + ++
++++++++++++++++++++
++++++++++++++++++++
