++++++++++++++++++++
++++++++++++++++++++
+++   ++++++++++++++
+++   ++++++++++++++
+++   ++++  ++++++++
++++  +++++  +++++++
++++  +++++   ++++++
++++A +++++   ++++++
++++a +++++0  ++++++
+++    ++++   ++++++
++++    +++    +++++
++++      +    +  ++
++++      +    +  ++
++++      +    +  ++
++++              ++
++++              ++
++++  ++           +
++++   ++          +
+++++  +++++++  + ++
++++++++++++++++++++
