++++++++++++++++++++
++++++++++++++++++++
++++++             +
++++++       0  a ++
++++++   ++  +++++++
++++++             +
+++          A     +
++        ++   ++  +
+++           +++  +
++++++++       ++  +
++++++++  +++  ++  +
++++++++ ++++  ++  +
+++++++++++++  ++  +
+++++++++++++  ++  +
+++++++++++++      +
++++++++++ ++      +
++++++++++  +  ++  +
++++++++++    +++  +
+++++++++++   +++ ++
++++++++++++++++++++
