++++++++++++++++++++
++++++++++++++++++++
+++++++++++++++++  +
++++++++++++++++   +
++++++++  ++++++   +
++++++++   +++     +
++++++++    ++     +
++++++++        +  +
++++++++        +  +
++++++++  +     0+++
+++++++  +       +++
++++++++ +         +
+++++  +++    A    +
++++++  ++    a    +
++++++  ++         +
++++++  +    +     +
++++++       ++    +
+++++++            +
++++++++++++      ++
++++++++++++++++++++
