++++++++++++++++++++
++++++++++++++++++++
+++++++++  +  +  +++
++++   ++     +    +
++++   ++          +
+++    ++          +
++++   ++          +
++ +   ++   ++  +  +
++          +   +  +
++                ++
++    ++          ++
++  0 ++        ++++
++    +         ++++
++    +     A  +++++
+++     ++     +++++
++++    ++   +++++++
+++++  +++ a++++++++
++++++ ++++ ++++++++
++++++++++++++++++++
++++++++++++++++++++
