++++++++++++++++++++
++++++++++++++++++++
++++++++        ++++
++++++++         +++
++++  ++  + a+++  ++
++++  ++  +  +++  ++
++++  ++  +   ++  ++
++++  ++  + A+++  ++
++++  ++  +  +++  ++
++ +  ++ ++  +++0 ++
++    +++++ +  ++  +
++    +++++++  ++  +
++    ++       ++  +
++             ++  +
+++                +
++++  ++++++       +
++++++++++++       +
++++++++++++       +
+++++++++++++   ++++
++++++++++++++++++++
