++++++++++++++++++++
++++++++++++++++++++
+++    +++++++++++++
+++    ++  +++++++++
+++    ++  ++++++  +
+++        ++   +  +
+++        0       +
++++            a  +
+++++        ++    +
+++++  A ++  ++    +
++++++   ++  ++    +
+++++++  ++  ++    +
+++++++ +++  ++    +
+++++++++++  ++    +
+++++++++++  ++    +
+++++++++++        +
++++++++++++       +
+++++++++++++++++  +
++++++++++++++++++++
++++++++++++++++++++
