++++++++++++++++++++
++++++++++++++++++++
+++++++++          +
++++++++++         +
++++++++++++++++   +
+++++       +++++  +
+++++        ++++  +
+++++        +++   +
+++            +   +
+++    +++    0    +
+++a   ++++  ++    +
++A  +++  +  ++    +
+++  +++  +  +++   +
++++++++  +        +
++++++++  +        +
++++++    +  ++++  +
+++++++     +++++  +
+++++++++   +++++  +
++++++++++++++++++++
++++++++++++++++++++
