++++++++++++++++++++
++++++++++++++++++++
+++++A ++  +++++   +
+++++              +
+++++              +
+++++  +++++++++   +
+++++  +++++++++   +
+++++  ++++++++++  +
+++++  +++++++++   +
+++++  +++++++++   +
++  +  +++++++++   +
++  + a++++++++    +
++     ++  ++++    +
+++    ++  ++++++  +
+++0               +
++++  +            +
++++++++   ++  ++  +
++++++++   ++  ++  +
+++++++++ +++++++ ++
++++++++++++++++++++
