++++++++++++++++++++
++++++++++++++++++++
+++++  0   +++  ++++
+++++   a   ++  ++++
++  +  ++++  +  ++++
++              +  +
++    A         +  +
++  +              +
++  ++             +
++  ++++++         +
++ ++++++++++      +
+++++++++++++      +
+++++++++++++      +
+++++++++++++     ++
++++++++++++++     +
+++++++++++++  ++  +
++++++++++++++     +
+++++++++++++++    +
+++++++++++++++++ ++
++++++++++++++++++++
