++++++++++++++++++++
++++++++++++++++++++
+++++++++++  ++++  +
+++++++0 ++  ++++  +
++++ ++   +  ++++  +
++++ a+   +        +
++  +              +
++  +          ++  +
++  +    ++    ++  +
++  +     +        +
++  +        +     +
++ A++     ++      +
++  +++    ++     ++
++  +  +   +  ++  ++
++  +      +  ++  ++
++  +      +  ++  ++
++  +      +  ++   +
++                 +
+++   +++         ++
++++++++++++++++++++
