++++++++++++++++++++
++++++++++++++++++++
++++++++      +++  +
++++++        +++  +
++++++    ++  +++  +
+++++              +
++++++  +          +
++++++  ++++       +
++++++  ++++++     +
++++++  a          +
++++++             +
+++++++    ++++    +
+++++++    ++++A   +
++++       ++++  +++
+++++     0   +  +++
+++++++           ++
+++++++    ++     ++
+++++++    ++   ++++
++++++++  ++++++++++
++++++++++++++++++++
