++++++++++++++++++++
++++++++++++++++++++
+++++++++          +
+++++++++          +
+++++++++A      +  +
+++++++++          +
+++++++++          +
+++++++++   a  ++  +
++++           ++  +
++++           +++++
++++  +++      +++++
++++  +++      +++++
+++++++++     0+++++
+++++++++   +   ++++
+++         ++   +++
++++        +++  +++
+++++++     ++++++++
+++++++   ++++++++++
++++++++ +++++++++++
++++++++++++++++++++
