++++++++++++++++++++
++++++++++++++++++++
++++++++++  ++   +++
++++++++++  ++     +
++++++++++  ++     +
++++++++++  +      +
++++++++++  +      +
++++++++++  +      +
++++++++++ A       +
++++++++++         +
++++++++++         +
++++++++++  a   +  +
+++   ++     0  +  +
++++   ++       ++++
+++++  ++++     ++++
+++++  ++++       ++
+++++  ++++        +
+++++       ++  +  +
++++++      ++++++++
++++++++++++++++++++
