++++++++++++++++++++
++++++++++++++++++++
++++++       +++++++
++++++        ++++++
++++++++++++       +
+++++++++++++      +
+++++++++++++++++  +
++++++++++++  +    +
++++++++++         +
++++++++++ 0    +  +
+++++  +++      + ++
+++++  +++       +++
+++++A +++    +    +
+++++  +++    +    +
+++++         +    +
+++++       a +    +
+++      +++  +    +
++++            +  +
+++++++++       + ++
++++++++++++++++++++
