++++++++++++++++++++
++++++++++++++++++++
+++++++++++++++++  +
+++++++++++++++    +
++++++  ++++       +
++++++  ++++       +
++++++  ++++   ++  +
++++++             +
++++++      a      +
++++++     ++      +
++++++ +   ++   +  +
+++++++++  ++++++  +
+++++++    +       +
++++++++ A ++      +
++++++++++++++++   +
+++++++++++++++++  +
++++++++++++++  0  +
+++++++++++++++    +
+++++++++++++++++ ++
++++++++++++++++++++
