++++++++++++++++++++
++++++++++++++++++++
++++++++++++       +
++++++++++++       +
++++++++++++       +
+++++  ++++        +
+++++  a++++  +++  +
+++++   ++++  +++  +
+++++   +++++++++  +
+++++   +++++++++  +
+++++    A   ++++  +
+++       0  +++++++
++++    ++    ++++++
+++++   ++     +++++
++++++  +++++  +++++
++++    +++++   ++++
++++    +++++   +  +
++++   ++++++     ++
+++++  +++++++ +  ++
++++++++++++++++++++
