++++++++++++++++++++
++++++++++++++++++++
+++++    +         +
+++++              +
+++++              +
+++++        0  +  +
+++   ++  A        +
+++   ++           +
++++++++           +
++++++++           +
++++++++    +      +
+++++++++   +   +  +
+++++++++++++  ++  +
+++++++++++++   a ++
+++++++++++++     ++
++++++++++++++ +++++
++++++++++++++++++++
++++++++++++++++++++
++++++++++++++++++++
++++++++++++++++++++
