++++++++++++++++++++
++++++++++++++++++++
+++++++         +  +
+++++++            +
+++++++  ++++++    +
+++++++  ++++++    +
++ ++++  ++  ++++  +
++   ++  +         +
+++   + A++        +
++++  +            +
++++               +
++++              ++
++++    a +++++   ++
+++++     +++++  +++
++++++++  +++++  +++
++++++0   +++    +++
++++++    +++    +++
++++++            ++
+++++++++      + +++
++++++++++++++++++++
