++++++++++++++++++++
++++++++++++++++++++
+++++++++++++++   ++
+++++++++++++++   ++
+++++++++++++++  +++
++++++++++++++     +
++++++++++  +++    +
+++++++ ++  +++ a  +
+++++++  +   ++++  +
+++++++  +         +
+++++    +  +      +
+++++    +  ++++   +
+++++      ++ ++   +
+++++    A ++   0  +
+++++   ++++       +
++++ +  ++         +
++++    ++         +
++++       ++++++  +
+++++      ++++++ ++
++++++++++++++++++++
