++++++++++++++++++++
++++++++++++++++++++
+++++    ++++  ++  +
+++++    ++++  ++  +
+++++ +   0 +  ++  +
++++++++       ++  +
+++++++++    A    ++
++++++++++        ++
+++++++++++  +   +++
+++++++++++a ++    +
+++++++++++  +++   +
+++++++++++  +++   +
+++++++++++  +     +
++++++++++         +
++++++++++  +      +
++++++++++         +
++++++++++         +
++++++++++  ++     +
+++++++++++++++   ++
++++++++++++++++++++
