++++++++++++++++++++
++++++++++++++++++++
++++++++++++       +
++++++++++++       +
++++++++++++  +++  +
++++++++++++  ++   +
++++++++++++  ++   +
+++  ++++++   ++   +
+++   ++++    +++  +
+++a  +++++   +++  +
+++   ++++++  ++   +
+++   ++++++  ++  ++
+++   ++++    ++  ++
+++   ++++  A ++  ++
+++    ++     ++  ++
+++           0+  ++
++++        +  +  ++
++++              ++
++++++          ++++
++++++++++++++++++++
