++++++++++++++++++++
++++++++++++++++++++
++++++++++         +
++++++++++         +
+++++  +++  +++    +
+++++  +++ +  +    +
+++++0   +         +
+++++    +         +
+++++    +  +   ++++
+++++    +  +   ++++
+++++++       ++++++
+++++++           ++
+++++++   +++   a  +
++++++ A  +++++++  +
++++++    +++++    +
+++++     +++++    +
++++++    ++++  ++++
++++++          ++++
+++++++++      +++++
++++++++++++++++++++
