++++++++++++++++++++
++++++++++++++++++++
+++++++++ ++++     +
+++++++++  +      ++
+++++++++          +
+++++++++      a   +
++++++++++   A     +
++++++++++  +      +
+++++++++++++      +
+++++++++++++      +
++++++++++++       +
+++++++++++++      +
+++++    0    ++   +
++++++        ++   +
+++++++++++++++++  +
+++++++++++++++++  +
+++++++++++++++++  +
++++++++++++++++++++
++++++++++++++++++++
++++++++++++++++++++
