++++++++++++++++++++
++++++++++++++++++++
+++++++     A+++++++
+++++++       ++++++
++++ ++  +       +++
++++  +  +         +
++++  +  +     +   +
++++  +        +   +
++++ a+        +   +
++++  +           ++
++++  +    +       +
++++  +  +++   ++  +
++++  +0           +
++++               +
+++++      ++++++  +
+++++++++  ++++++  +
+++++++++ +++++++  +
+++++++++++++++++  +
+++++++++++++++++ ++
++++++++++++++++++++
