++++++++++++++++++++
++++++++++++++++++++
++++     ++++      +
++++     ++++      +
++++     ++++  ++  +
+++      +   A0 ++++
+++      ++     +  +
+++     +++ +   +  +
+++     + +        +
+++     +  +       +
+++++  a           +
+++++              +
+++++  ++  ++++    +
+++++  ++  ++++    +
+++++  ++  ++++    +
+++++  ++  ++++    +
+++++  +++++++++   +
+++++  ++++++++++ ++
++++++++++++++++++++
++++++++++++++++++++
