++++++++++++++++++++
++++++++++++++++++++
+++++++++++++ 0 A ++
+++++++++++++      +
+++++++++++++   +  +
+++++++++++++   +  +
+++++++++++++   ++++
+++++++++++++   ++++
+++++  ++++++   ++++
+++++  ++++++   +  +
+++++  ++++++   +  +
+++++   +++++      +
+++++    +      +  +
+++++              +
+++++  +   ++      +
+++++    ++++  ++  +
++++++ a      +++  +
++++++++           +
+++++++++         ++
++++++++++++++++++++
