++++++++++++++++++++
++++++++++++++++++++
++++++++           +
++++++             +
++++++             +
++++++          0  +
++++++         ++  +
++++++       A ++  +
++++++             +
+++++              +
++++ a   ++  +     +
++++   ++++  +     +
+++++        +    ++
+++++++      +  + ++
+++++++ ++++++ +++++
++++++++++++++++++++
++++++++++++++++++++
++++++++++++++++++++
++++++++++++++++++++
++++++++++++++++++++
