++++++++++++++++++++
++++++++++++++++++++
++++++++           +
++++++++     A     +
++++  ++           +
++++  ++           +
++++  ++           +
++++              ++
++++       +      ++
++++  +        a  ++
++++ +++++        ++
++++++++++++  ++  ++
++++++++++++  ++  ++
++++++++++++   +  ++
++++++++++++      ++
++++++++++++      ++
++++++++++++   0++++
++++++++++++    ++++
++++++++++++++++++++
++++++++++++++++++++
