++++++++++++++++++++
++++++++++++++++++++
++++++++++++++  ++++
++++++++++++++ a   +
++++++++++++++     +
++++++++++++++  +  +
++++++++++++++  +  +
++++      +++   +  +
+++++      ++   +  +
++++++  +  ++  ++  +
++++++      +  ++  +
++++++      0A     +
++++++             +
++++++  ++      +  +
++++++             +
++++++             +
++++++++   ++++++  +
+++++++++++++++++  +
+++++++++++++++++ ++
++++++++++++++++++++
