++++++++++++++++++++
++++++++++++++++++++
++++++++++   ++++  +
++++++++++         +
++++++++++        ++
+++++++++++  +   +++
+++++++  ++      +++
++++++++  ++     +++
++++++++    +++  +++
++++++++    0+++  ++
++++++++      ++  ++
++++++++       +   +
++++++++       +   +
++++++++  +  a +   +
++++++++  + +      +
++++++++  +++++    +
+++++++ A          +
++++++++           +
++++++++++ ++++++ ++
++++++++++++++++++++
