++++++++++++++++++++
++++++++++++++++++++
++++  +++    ++++  +
+++++  ++    +     +
+++++  ++   ++     +
++ ++           +  +
++  +     0     ++++
++           +   +++
+++    ++++  +a   ++
+++++  ++++  +     +
+++++  +++++++  +  +
+++++  +++++++  +  +
+++++A +   +++  +  +
+++++  +    ++  +  +
++++++++    ++  +  +
++++++++ +      +  +
+++++++++        +++
++++++++++    +    +
++++++++++++++++  ++
++++++++++++++++++++
