++++++++++++++++++++
++++++++++++++++++++
++++++   +++++++++++
+++ ++   ++++++++  +
+++  +   ++++++++  +
+++  +    ++ ++++  +
+++                +
+++                +
++                 +
++    A            +
++a +++   +        +
++  +++       0    +
++++++++     ++++  +
+++++++++++++++++  +
+++++++++++++++++  +
+++++++++++++++++  +
+++++++++++++++++  +
+++++++++++++++++  +
+++++++++++++++++ ++
++++++++++++++++++++
