++++++++++++++++++++
++++++++++++++++++++
+++++  +           +
+++++  ++          +
+++++  +++++   +   +
+++++   ++++   ++  +
+++++      +       +
+++++         +    +
+++++     +++ +++  +
+++++     +++++++  +
+++      0++++++++++
+++      +   +++++++
+++      +    ++++++
+++ A    +    ++++++
++  +++  ++       ++
++  +++  ++++      +
++  +++ a++++++++  +
+++++++++++++++++  +
++++++++++++++++++++
++++++++++++++++++++
