++++++++++++++++++++
++++++++++++++++++++
+++++++  ++  ++++  +
+++++++0 ++        +
+++++++            +
+++++++  A    +++  +
+++++++       +++  +
+++++++      +++++++
++++++++     +++++++
+++++++++       +  +
+++++++++       +  +
+++++++++    ++++  +
+++++++++    ++++  +
++++++    +  +++   +
+++++++   +    +   +
+++++++++++ a      +
+++++++++++        +
+++++++++++        +
++++++++++++++++++++
++++++++++++++++++++
