++++++++++++++++++++
++++++++++++++++++++
+++    +++++++++++++
+++     ++++++++++++
+++  +   +++++++++++
+++  ++   +  +++++++
+++       +  ++++  +
+++ +     A  ++ +  +
++++++++     ++    +
++++++++a    ++    +
++++++ +      +    +
++++++             +
++++++          0  +
++++++  +          +
++++++      +++    +
++++++      +++    +
++++++     +++++   +
++++++     ++++++  +
+++++++   ++++++++++
++++++++++++++++++++
