++++++++++++++++++++
++++++++++++++++++++
+++++++   ++  ++++++
+++++++      ++    +
++++++ 0     ++    +
++++++       +  a  +
++++++   ++        +
++++++    +       ++
++++++           +++
++++++            ++
+++++++            +
+++++++            +
+++++++     ++     +
+++++++A     +++   +
+++++++  ++        +
+++     ++++       +
++++    +++++++++  +
+++++++++++++++++  +
+++++++++++++++++ ++
++++++++++++++++++++
