++++++++++++++++++++
++++++++++++++++++++
++++++         +++++
++++++         +++++
+++++++   +    +++++
+++++++     +  ++  +
+++++++++       +  +
+++++++++  +       +
+++++++++  +  +   ++
+++++++++  +  +   ++
+++++++++  + 0    ++
+++++++++          +
+++++++       +  +++
+++++++    +   A   +
++++++             +
+++++++       ++   +
+++++++a  ++++++   +
+++++++  +++++++   +
+++++++++++++++++ ++
++++++++++++++++++++
