++++++++++++++++++++
++++++++++++++++++++
+++++++         +  +
+++++++            +
+++++++            +
+++++++  +++ a     +
+++++++  ++    +   +
+++++++  ++   A++  +
+++++++ +++    ++  +
++++++++          ++
++++++            ++
++++++ 0    +   ++++
++++++     ++   ++++
+++++  ++  ++   +  +
+++ +  ++++++   +  +
+++   ++++++    +  +
+++   +++++++      +
+++   +++++++++    +
++++ +++++++++++++++
++++++++++++++++++++
