++++++++++++++++++++
++++++++++++++++++++
++  +++++++++++++  +
++      ++++++  +  +
++++     +++++     +
++++++   ++  +     +
++++++    +  +  +  +
++++++  a +  +  +  +
++++++         ++  +
++++++      A   +  +
++++++  +++  +  +  +
+++      +  ++  +  +
++++        ++     +
++++++     +++     +
+++++++  +++++ 0   +
+++++++++++++++    +
+++++++++++++++    +
+++++++++++++++    +
++++++++++++++++  ++
++++++++++++++++++++
