++++++++++++++++++++
++++++++++++++++++++
+++     a ++  +    +
++++       +  +    +
++++++ ++  +  +    +
++++++  +  +       +
++++++             +
++++  A         0  +
+++++             ++
+++++++++  +      ++
+++++++++    +    ++
++++++++++   +    ++
++++++++++++++    ++
+++++++++++++++   ++
++++++++++++++++  ++
++++++++++++++++  ++
+++++++++++++++++ ++
++++++++++++++++++++
++++++++++++++++++++
++++++++++++++++++++
