++++++++++++++++++++
++++++++++++++++++++
+++        +++   +++
++++       +      ++
+++++++++0     +   +
+++++++++   a  +   +
+++++++++      +   +
+++++++++          +
+++++++++  +       +
+++++++++  +++     +
+++++++++    +     +
+++++++++    ++    +
+++++++++    +++   +
+++++++++   ++++   +
+++   +++   ++++   +
++++   +++  ++++   +
+++++   ++ A++++  ++
++++++        ++  ++
++++++++     +++++++
++++++++++++++++++++
