++++++++++++++++++++
++++++++++++++++++++
+++++       +++  +++
+++++            +++
+++++++++  +     +++
++++++++   ++++  +++
++++++++  ++++++++++
++++++++  ++++++++++
++  ++++   +++++++++
++         ++++++  +
++ 0    A  ++++++  +
++   ++ a    ++++  +
++  +++      ++++  +
++  ++++   ++++++  +
++ +++++    ++++   +
+++++++++    ++++  +
++++++++++         +
+++++++++++        +
+++++++++++++++   ++
++++++++++++++++++++
