++++++++++++++++++++
++++++++++++++++++++
+++++        ++  +++
++++       0      ++
+++++        A    ++
++++++            ++
++++++      +++++  +
++++++ +++  ++++   +
++++++++++++++++   +
++++++++++++++++   +
+++++++++++++++    +
+++++++++++++++    +
+++++++++++++++a   +
++++++++++++++     +
++++++++++++++     +
++++++++++++++  +  +
++++++++++++++  + ++
++++++++++++++++++++
++++++++++++++++++++
++++++++++++++++++++
