++++++++++++++++++++
++++++++++++++++++++
++++++++   A+++a   +
++++++++    +++    +
++++++++    ++     +
+++++ ++           +
+++++     +        +
++++++    ++       +
++++++++ 0+++      +
+++++++++++++      +
+++++++++++        +
++++++++++++       +
+++++++++++++++    +
+++++++++++++++    +
+++++++++++++++    +
+++++++++++        +
+++++++++++        +
+++++++++++++++++  +
++++++++++++++++++++
++++++++++++++++++++
