++++++++++++++++++++
++++++++++++++++++++
++++++++++++++  ++++
++++++++++++++  ++++
++++++++++++++  ++++
++++++++++++++  ++++
++++ 0    ++    +  +
++ +       +      ++
++    +++         ++
++    +++ A   ++++++
++         +  ++++++
++            ++++++
++              ++++
++    ++++++     +++
+++   +++++   +   ++
++++  +++++   + a ++
++++  +++++   +   ++
++++          ++  ++
++++++      ++++++++
++++++++++++++++++++
