++++++++++++++++++++
++++++++++++++++++++
+++++++++++++      +
+++++++++++++      +
+++++++++++  A  +  +
++++++  +++        +
++ +++        + a  +
++  +++       ++   +
++      ++++0 +++  +
+++     ++++  +++  +
++++++  ++++  +++  +
++++++  ++++       +
++++++  +++++      +
++++++  +++++++++  +
++++++  +++        +
++++++  +++        +
++++++  +++ ++++++++
++++++  ++++++++++++
++++++++++++++++++++
++++++++++++++++++++
