++++++++++++++++++++
++++++++++++++++++++
++++++   +         +
+++++       A      +
+++++       a  ++  +
+++++              +
++++++++    +  0  ++
+++++++        +++++
+++++++       ++++++
+++++++       ++++++
+++++++  +++++++++++
+++++++  +++++++++++
+++++++  ++++++++  +
+++++++  ++++      +
+++++++  ++++      +
+++++++        ++  +
++   ++  +     ++  +
+++     +++++  ++  +
+++++   ++++++++++++
++++++++++++++++++++
