++++++++++++++++++++
++++++++++++++++++++
++++++++++  +  ++  +
++++            +  +
++++          0    +
++++++   ++  +     +
++++++ A ++  +  +  +
++++++a            +
+++++++            +
+++++++++++  +     +
++++++++++++       +
++++++++++++       +
++++++++++++       +
+++++++++++++ +    +
++++++++++++++++   +
+++++++++++++++++  +
++++++++++++++++++++
++++++++++++++++++++
++++++++++++++++++++
++++++++++++++++++++
