++++++++++++++++++++
++++++++++++++++++++
+++ A   ++  ++++++++
+++         +a +++++
+++  +      +      +
+++  +  ++  +      +
+++++   ++  +      +
+++++   +          +
+++++              +
++++++      +    +++
++++++++    +    +++
++++++           +++
++++++           +++
++++++           +++
++++++ +++   ++ 0+++
++++++++++  +++  +++
+++++++++++ +++   ++
+++++++++++++++  +++
++++++++++++++++ +++
++++++++++++++++++++
