++++++++++++++++++++
++++++++++++++++++++
+++++++++++++  ++  +
+++++++++++++  ++  +
++++++++           +
+++++++++          +
++++ +++++++   +   +
++++  ++++++ 0    ++
++++  +++++++      +
++++  ++++++++     +
++++   ++++++++++  +
+++++   +++++++++  +
++++++  +++++++++  +
++++++  +++++++++  +
++++++   A  ++     +
++++++             +
++++++        a +  +
++++++  +      +++++
+++++++ ++     +++++
++++++++++++++++++++
