++++++++++++++++++++
++++++++++++++++++++
++++  ++    ++ 0   +
++++  +++   ++     +
++++  ++++         +
++++  +++++    +   +
++++   +++++++     +
++++   +++     A   +
+++++  +++        ++
+++++   ++a   +   ++
+++++   ++    ++  ++
+++++   ++   ++++  +
+++++   ++   +++++++
+++++  +++   +++++++
++++++ +++   +++++++
++++++++++   +    ++
++++++  +++++      +
+++++++        ++  +
++++++++      ++++++
++++++++++++++++++++
