++++++++++++++++++++
++++++++++++++++++++
++++++++++++  ++++++
++++++++++++  +  +++
++++++++++       +++
+++++++++++      +++
++++++++++        ++
++++++++++         +
++++++        +    +
+++++++       +    +
++++ ++++++a  ++   +
++++  +++++  ++++  +
++++  +  ++     +  +
++++  +  +++       +
++++  +  +++++     +
++++  + A++        +
++++ 0+            +
++++               +
+++++       +++++ ++
++++++++++++++++++++
