++++++++++++++++++++
++++++++++++++++++++
++++  ++++++++++++++
++++  ++++++++++  ++
++++  ++++++++++   +
++++  ++++++++++   +
++++               +
+++++ 0            +
+++++++++    +  a  +
++++++++           +
+++++              +
+++++     ++++     +
+++++ A+  ++++     +
+++ +  ++++++++    +
+++    ++++++ +    +
+++    ++++        +
++++               +
++++        +     ++
++++++++++++++    ++
++++++++++++++++++++
