++++++++++++++++++++
++++++++++++++++++++
++++++++   ++      +
+++++++++          +
++++++    0    +   +
++++++             +
+++    ++          +
+++    ++      ++  +
+++  +++  +        +
+++a++++  +  +     +
+++++++++++  ++++  +
+++++++++++  ++++  +
+++++++++++  ++++  +
+++++++++++  ++++  +
+++++++++++  ++++  +
+++++++++++  ++++  +
+++++++++++  A ++  +
++++++++++++      ++
+++++++++++++++  +++
++++++++++++++++++++
