++++++++++++++++++++
++++++++++++++++++++
+++++++++++++++++  +
+++++++++++++++++  +
++++++++++         +
++++++++++ A       +
++++++++++++++++   +
++++++++++++++++   +
++++++++++++++++   +
+++++++++++        +
++++++++  ++       +
+++++++       +++  +
+++++++      a     +
+++++++  +++++     +
+++++++   0 ++  +  +
++++ ++         +  +
++++     +++       +
++++    +++++      +
+++++++ +++++++++ ++
++++++++++++++++++++
