++++++++++++++++++++
++++++++++++++++++++
++     ++  +++++++++
++     ++  ++  +++++
++ ++  ++  ++    +++
+++++  ++        +++
+++++  ++        +++
+++++  +++++  +  +++
+++++  +++++  +    +
+++++  +++++  +    +
++++   ++++   +    +
+++    ++    A     +
++++  a++  0       +
++++   ++      +   +
+++++     +    ++  +
+++++     +   +++  +
+++++     +   +++  +
+++++       +++++  +
++++++ ++   ++++++++
++++++++++++++++++++
