++++++++++++++++++++
++++++++++++++++++++
+++  ++++++++0 ++  +
++++  ++++         +
++++  a            +
+++++      ++  ++  +
+++++++++++++  ++  +
+++++++++++++  ++  +
+++++++++++++  +   +
++++++++++++       +
++++++++++++       +
++++++++++++       +
++++++++++++       +
++++++++++++       +
++++++++++++       +
++++++++++++A+++   +
++++++++++++++++   +
++++++++++++++++   +
++++++++++++++++++++
++++++++++++++++++++
