++++++++++++++++++++
++++++++++++++++++++
+++++++++          +
+++++++++          +
++++++++   ++A0    +
++++++++           +
++++++++           +
++++++++  +++      +
++++++++  +++   a  +
++++++++ +++++     +
+++++++++++++++    +
+++++++++++++++    +
+++++++++++++++    +
+++++++++++++++    +
++++++++++++++++   +
+++++++++++++++++  +
+++++++++++++ +++  +
+++++++++++++      +
++++++++++++++    ++
++++++++++++++++++++
