++++++++++++++++++++
++++++++++++++++++++
++++++++++++++++++++
++++++       +++++++
++++++       ++++  +
++++++       ++++  +
++++ +   A   ++++  +
++++    a    ++++  +
++++     0 ++++++  +
+++++  +   ++++++  +
+++++  ++   +++++  +
+++++  ++   +   +  +
+++++++++          +
+++++++++          +
+++++++++     +    +
+++++++++          +
++++++++++         +
+++++++++++        +
++++++++++++++    ++
++++++++++++++++++++
