++++++++++++++++++++
++++++++++++++++++++
+++++++++++++  ++  +
+++++++++++++  ++  +
+++++++++++++     ++
+++++++++++       ++
+++++++  0        ++
+++++++ a          +
+++++++            +
++++++++           +
+++         +   +  +
++++        +      +
++++++++  ++ ++    +
++++++++  ++  +    +
+++++++  +++       +
++++++++ ++++   A  +
+++++++++++++++++  +
+++++++++++++++++  +
+++++++++++++++++ ++
++++++++++++++++++++
