++++++++++++++++++++
++++++++++++++++++++
++++      a++   +  +
+++++              +
+++++++ +          +
++++++++    0A     +
+++++++++      ++  +
+++++++++++++      +
++++++++++++++     +
+++++++++++++++ +  +
+++++++++++++++    +
++++++++++++++++   +
+++++++++++++++++  +
+++++++++++++++++  +
+++++++++++++++++  +
++++++++++++++++++++
++++++++++++++++++++
++++++++++++++++++++
++++++++++++++++++++
++++++++++++++++++++
