++++++++++++++++++++
++++++++++++++++++++
+++++++++++++  +++++
+++++++ +++++  +++++
++++++   ++++    +++
++++++     ++     ++
++++++     +++    ++
+++++++        a   +
+++++++   A     0  +
+++++++            +
+++++++            +
+++++      +       +
+++++              +
++++++++++         +
++++++++++  ++  +  +
++++++++++  ++     +
++++++++++++++     +
+++++++++++++++    +
+++++++++++++++++ ++
++++++++++++++++++++
