++++++++++++++++++++
++++++++++++++++++++
++  ++++++++++++++++
++  +++ ++++++++++++
++  +++  +++++++++++
++  +++  +++++++++++
++ 0++++  ++++++++++
++  +++   +++++++  +
++        ++   ++  +
+++             +  +
+++++++       a +  +
++++++++        +  +
+++++++++          +
++++  ++++         +
++++  ++++   +  +  +
++++     A         +
+++                +
++++ +++           +
+++++++++++++++   ++
++++++++++++++++++++
