++++++++++++++++++++
++++++++++++++++++++
+++++++++++     ++++
+++++++++++     ++++
+++++++++++      +++
++++++++++++     +++
+++++++++  +   +++++
+++++++++  +   +++++
+++++++++      +++++
++++++  +      +++++
++++++0           ++
++++++  +          +
++++++             +
++++++         +   +
+++++    +A        +
++++++   ++ a      +
+++++++  ++   +++  +
+++++++  +++  +++  +
+++++++++++++++++ ++
++++++++++++++++++++
