++++++++++++++++++++
++++++++++++++++++++
+++++        ++++  +
+++++        a++   +
+++++      +  +++  +
+++++      +  +++  +
++++++  ++++  +++  +
++++++  ++++    +  +
+++     ++++    +  +
++      ++         +
++  A              +
++  ++          +  +
++ +0          ++  +
++++            +  +
++++  ++++++++  +  +
++ +  ++++++++  +  +
++   +++++++++  +  +
+++  +++++++++     +
+++++++++++++++   ++
++++++++++++++++++++
