++++++++++++++++++++
++++++++++++++++++++
+++++++++++++++    +
+++++++++++++++    +
+++++++       +    +
+++++++            +
+++++++  ++++  0   +
+++++++ +++++++ +  +
+++++++++++++++    +
+++++++++++++++    +
+++++++++       ++++
+++++++++      +++++
+++++++++A   a +++++
+++++++++      +++++
+++++++++      +++++
+++++++++      +++++
++++           +++++
++++             +++
++++++++++++     +++
++++++++++++++++++++
