++++++++++++++++++++
++++++++++++++++++++
+++++  ++++++      +
+++++   ++++++     +
+++++   +++++++    +
++++++  ++++    A  +
++++++  ++a        +
++++++  +++    ++  +
++++++             +
+++                +
++++   ++++++++++  +
+++++++++++++++++  +
+++++++++++++++++  +
++++++++++++ 0+++  +
++++++++++++  +++  +
++++++++++++  +++  +
++++++++++++  +++  +
++++++++++++       +
+++++++++++++     ++
++++++++++++++++++++
