++++++++++++++++++++
++++++++++++++++++++
++     ++++     ++++
++     ++++        +
++  +0 ++++  +     +
++  +  ++++  ++ +  +
++  +  ++++  ++++  +
++  +  ++++  ++++  +
+++++       +++++  +
+++++      a+++++  +
++++++        +++  +
++++++        +++  +
+++++         +++  +
+++++         +++  +
+++++         +++  +
++ ++     +   A   ++
++      ++++      ++
++      +++++    +++
+++    +++++++ +++++
++++++++++++++++++++
