++++++++++++++++++++
++++++++++++++++++++
++++++++++++++++++++
+++++++++++++++++  +
+++++++++++++++++  +
++++++++++++ +++  ++
+++++++       ++   +
+++++++       ++   +
+++++++   ++  +    +
+++++++    +a +    +
+++++++    +    A  +
++++       ++      +
+++++      ++      +
+++++++    ++      +
++++++++   ++   +  +
++++++++     0  +  +
+++++++++          +
+++++++++       +  +
+++++++++++++++++ ++
++++++++++++++++++++
