++++++++++++++++++++
++++++++++++++++++++
++++  ++++++++++++++
++++  ++++++++++++++
++++  ++++++++++++++
++++A ++++++++++++++
++         +++++++++
++       a      ++++
++  +  ++        +++
++  +  +++    +    +
+++++  +++    +    +
++++++  ++      +  +
++++++  ++      +  +
++++++  ++0     +  +
++++++  +++     +  +
++++++  ++++   ++  +
++++++  ++++++  +  +
++++++  ++++++    ++
+++++++++++++++   ++
++++++++++++++++++++
