++++++++++++++++++++
++++++++++++++++++++
++++++++    ++++++++
++++++++    +++  +++
+++++++     +++    +
+++++++  +  ++     +
++++++++ +  ++     +
++++++++++  ++  +  +
++++++++++  ++ 0+  +
++++++++        +  +
++ +++++           +
++  ++++ A+++      +
++  ++++  ++++     +
++  +++  +++++     +
++       +++       +
+++     +++++      +
+++  a        +    +
++++          +    +
+++++++++++++++++ ++
++++++++++++++++++++
