++++++++++++++++++++
++++++++++++++++++++
+++++++++++++++++  +
+++++++++++++++++  +
+++++++++++++++++  +
+++++++            +
+++++++            +
+++ 0   A          +
+++                +
+++++++  ++        +
+++++++  ++        +
+++++++  ++        +
+++++++ +++  a     +
++++++++++++       +
++++++++++ +       +
++++++++++   +     +
++++++++++   +     +
++++++++++  ++    ++
+++++++++++++++   ++
++++++++++++++++++++
