++++++++++++++++++++
++++++++++++++++++++
+++++++            +
+++++              +
+++++      a       +
+++++ +  +  ++  + ++
+++++++  +++++  ++++
+++++++  +++++     +
+++++++  +++++  A  +
+++++++0 +++++  +  +
+++++++  ++++++++  +
+++++ +  ++++++++  +
+++++    +++  +++  +
+++++    ++++  ++  +
+++++   +++++      +
++++++  +++++      +
+++++++++++++  ++  +
+++++++++++++  ++  +
++++++++++++++++++++
++++++++++++++++++++
