++++++++++++++++++++
++++++++++++++++++++
++++++++++++++++   +
++++++++++++++++   +
++++++++     +++   +
++     +      ++   +
++ 0      ++  ++a  +
++ +++   ++        +
++++++             +
++++++             +
++++++++++++++     +
++++++++++++++     +
++++++++++++++     +
++++++++++++++  +  +
++++++++++++++  +  +
++++++++++++++  A  +
++++++++++++++     +
++++++++++++++     +
+++++++++++++++++ ++
++++++++++++++++++++
