++++++++++++++++++++
++++++++++++++++++++
++++++++++++++ ++  +
++++++++++++++A +  +
++++++++++++++  +  +
+++++++            +
++ +++             +
++         a       +
+++      +++       +
++      0+++       +
+++      +++       +
+++  +++++++       +
+++  +++++++       +
+++++++++++++      +
+++++++++++++     ++
+++++++++++++   + ++
+++++++++++++   ++++
++++++++++++++++++++
++++++++++++++++++++
++++++++++++++++++++
