++++++++++++++++++++
++++++++++++++++++++
+++  ++++++++  +   +
+++      ++++      +
+++       +++      +
+++  +++   ++ a    +
+++  +++    +      +
++  ++++      A    +
+++ ++++   +       +
++++++++  0++  +   +
+++++++    ++  +   +
++++++++           +
++++++++         +++
+++++++++  ++    +++
+++++++++  ++  +++++
+++++++++++++  +++++
+++++++++++++  +++++
++++++++++++++++++++
++++++++++++++++++++
++++++++++++++++++++
