++++++++++++++++++++
++++++++++++++++++++
++++++   ++++++++  +
++++++            ++
++++++      A     ++
++++++++  ++++++++++
++++++++  +++++++  +
++++++++           +
+++++++++          +
++++++      a      +
+++++++    ++++++  +
+++++++++  ++++++  +
+++++++++  ++++++  +
+++++++++++++++    +
+++++++++++++++    +
++++++++++++++     +
++++++++++++++  0  +
+++++++++++++++ +  +
+++++++++++++++++ ++
++++++++++++++++++++
