++++++++++++++++++++
++++++++++++++++++++
+++++++++++++++++  +
+++++++++++++      +
++++++++++++++     +
+++++++++++++++++  +
++++++++++++++++   +
+++++ +++++        +
+++++  +++ +       +
+++++  +++    A    +
+++++  ++++        +
+++++  +++         +
+++       a   +++  +
+++           +++  +
+++           +++  +
+++ +  0      +++  +
+++++  +++++  +++  +
+++++  +++++  +++  +
++++++++++++++++++++
++++++++++++++++++++
