++++++++++++++++++++
++++++++++++++++++++
++      +          +
++      +     0    +
++  ++             +
++A  ++       +    +
++    ++      ++   +
++         +  ++   +
++   a        ++   +
++  ++  ++    +   ++
++  ++  ++++  +   ++
++  ++  ++++  ++ +++
++  ++++++++++++++++
++  ++++++++++++++++
++ +++++++++++++++++
++++++++++++++++++++
++++++++++++++++++++
++++++++++++++++++++
++++++++++++++++++++
++++++++++++++++++++
