++++++++++++++++++++
++++++++++++++++++++
+++++++   ++++++++++
+++++++    +++++++++
++++ ++    +++++++++
++++  +  +  +++++  +
++++     +  +++++  +
++++     +  +++++  +
++++     +      +  +
++++     ++     0  +
++++  a  ++++++    +
+++++++  ++++++++  +
++++++    +++++++  +
++++++             +
+++++++            +
+++++++     ++++   +
+++++++  A  +++++  +
+++++++     +++++  +
++++++++++++++++++++
++++++++++++++++++++
