++++++++++++++++++++
++++++++++++++++++++
++++++++     ++++  +
++++++++  0  ++++  +
++++++       + ++  +
++  ++             +
++     ++          +
+++  A ++  +   ++  +
+++++++++  +       +
+++++++++++++ a    +
+++++++++++++++    +
+++++++++++++++    +
+++++++++++++++    +
+++++++++++++++    +
+++++++++++++++    +
+++++++++++++++    +
+++++++++++++++    +
+++++++++++++++++  +
+++++++++++++++++ ++
++++++++++++++++++++
