++++++++++++++++++++
++++++++++++++++++++
++++++++++  ++  +  +
++++++++++    +    +
+++++++ 0     + a  +
++++ ++       + A  +
++++          +    +
++++               +
++++  +    +       +
+++++++    +  +++  +
+++++++    +  +++  +
+++++++   ++  +    +
+++++++   ++       +
+++++++  +++       +
+++++++ ++++       +
++++++++++++       +
++++++++++++++ ++  +
+++++++++++++++++  +
+++++++++++++++++ ++
++++++++++++++++++++
