++++++++++++++++++++
++++++++++++++++++++
+++++++++++0 +++++++
+++++++++++   ++++++
+++++++++       ++++
+++++++++a         +
++++              ++
+++++             ++
++++++++ A       +++
++++++++           +
+++++++   +++      +
+++ ++++  +++  +   +
+++  ++  +++++++  ++
+++  ++  +++++    ++
+++  +   + +++    ++
+++         ++  ++++
++++              ++
++++++             +
+++++++     ++    ++
++++++++++++++++++++
