++++++++++++++++++++
++++++++++++++++++++
++++   +++++       +
++++   +   +       +
++++  A+    +      +
+++++  +   a++     +
++++++0            +
++++++    +        +
+++++++   +++   +  +
++++++++  +++   +  +
++++++++           +
+++++++++         ++
++++++++++++++  ++++
++++++++++++++  ++++
++++++++++++++ +++++
++++++++++++++++++++
++++++++++++++++++++
++++++++++++++++++++
++++++++++++++++++++
++++++++++++++++++++
