++++++++++++++++++++
++++++++++++++++++++
+++++++++++++  +  ++
+++++++++++++     ++
++++++++         +++
+++++++           ++
++++ +     ++      +
++++        +   +  +
++++     a      +  +
++++   +           +
++++      A        +
++++               +
++++  +++++        +
++++  ++++++       +
++++  ++++++++0++  +
++++  ++++++++++++++
++++  ++++++++++++++
++++++++++++++++++++
++++++++++++++++++++
++++++++++++++++++++
