++++++++++++++++++++
++++++++++++++++++++
++    +      ++    +
++     A           +
++     a  ++       +
++++      ++++     +
++++     +++++  +  +
++++  0  ++++++++  +
++++  +  ++++++++  +
+++++ +  ++++++++  +
+++++++  ++++++++  +
+++++++++++++++++  +
+++++++++++++++    +
+++++++++++++++    +
+++++++++++++++    +
+++++++++++++++    +
+++++++   +++++    +
+++++++            +
++++++++        ++++
++++++++++++++++++++
