++++++++++++++++++++
++++++++++++++++++++
++++++++++   +++  ++
++++++++++         +
++++++++    a      +
++++++++           +
++++++         A   +
+++++++            +
+++++++++++0       +
+++++++++++    ++  +
+++++++++++++  ++  +
+++++++            +
+++++++            +
+++++++  ++++  ++  +
+++++++  ++++  ++  +
+++++++  ++++  ++  +
+++++++ +++++  ++  +
+++++++++++++++++ ++
++++++++++++++++++++
++++++++++++++++++++
