++++++++++++++++++++
++++++++++++++++++++
++      +      ++  +
++              +  +
++++++     ++   +  +
++++++++  +++   +  +
++++++++  +++ a    +
++++++++  +++      +
+++++++   +++   +  +
++++++++  +++   +  +
++++++++  + +     ++
++++++++  +       ++
++++++++  ++   +++++
++++++++  +   ++   +
++++++++  +   ++   +
++++++++  +   ++   +
++++++++A     0    +
++++++++          ++
+++++++++ +++     ++
++++++++++++++++++++
