++++++++++++++++++++
++++++++++++++++++++
+++++++ ++++++++++++
+++++++  + ++++++  +
++    +  +  +++++  +
+++            ++  +
+++++              +
+++++              +
++++++      a   +  +
++++++  ++         +
++++++  ++         +
++++++  ++  ++A    +
++++++     ++++++  +
++++ ++    ++++++  +
++++  +++++++++++  +
++++0 +++++++++++  +
+++++          +   +
+++++             ++
++++++  +++++++  +++
++++++++++++++++++++
