++++++++++++++++++++
++++++++++++++++++++
++++   A a         +
++++               +
++++   ++++++++++  +
++++   ++++++++++  +
++++   ++++++++++  +
+++++  ++++++++++  +
+++++  ++++++++++  +
+++++  ++++++++++  +
+++++++++++++++++  +
++++++++++++++++   +
++++++++++++++++   +
++++++++++++++++   +
++++++  ++++++++0  +
++++         +++   +
+++++         ++   +
++++++             +
++++++++          ++
++++++++++++++++++++
