++++++++++++++++++++
++++++++++++++++++++
+++++              +
+++++              +
+++++  ++   +  ++  +
+++++   +   +      +
+++++       +      +
+++++  +       ++  +
+++++  +       ++  +
+++++  +       ++  +
++++  ++   0   ++  +
++++  +++a     ++  +
++   +++++   A ++  +
+++  ++++++  +++++++
+++++++++++  +++++++
+++++++++++  +++++++
+++++++++++  +++++++
+++++++++++   ++++++
++++++++++++  ++++++
++++++++++++++++++++
