++++++++++++++++++++
++++++++++++++++++++
+++ +++++++  ++    +
+++  +        ++   +
+++  ++            +
+++                +
++++ 0    ++  +++  +
++++++++++++  ++   +
++++++++++++       +
++++++++++++       +
++++++++++++  +    +
+++++++++     + a  +
+++++++++     +    +
+++++++    +  +    +
+++++++  A++    +  +
++++++    ++    +  +
+++++++ ++++  +++  +
+++++++++++++ +++  +
+++++++++++++++++ ++
++++++++++++++++++++
