++++++++++++++++++++
++++++++++++++++++++
+++++    ++++++++  +
+++++     +        +
+++++ ++   A a     +
++++++++    ++  +  +
+++             +  +
++++               +
+++++++++          +
+++++++++   +  ++  +
+++++++++  ++  ++  +
+++++++++  ++      +
+++++++++  ++      +
+++++++++  ++   +  +
++    0 +  ++   +  +
+++       + +  ++  +
++++++++  +  +++  ++
+++++++++++       ++
++++++++++++     +++
++++++++++++++++++++
