++++++++++++++++++++
++++++++++++++++++++
+++ A      a       +
+++                +
++++++++++  +++++  +
++++++++++  +++++  +
++++++++++  +++++  +
++++++++++     ++  +
+++++++        ++  +
++++++++       ++  +
+++++++++++    ++  +
+++++++++++    ++  +
++++++++ +   0 ++  +
++++++++       ++  +
++++++ ++      ++  +
++++++  +++    ++  +
+++++++  ++++      +
+++++++           ++
++++++++          ++
++++++++++++++++++++
