++++++++++++++++++++
++++++++++++++++++++
+++++++++++++++    +
++++++++++++  +    +
++++++++++++    +  +
+++++++++  +    +  +
+++++++    +  +   ++
++++++++     ++  +++
++++++ ++        +++
++++++  +         ++
++++++  +  ++0     +
++++++     ++      +
+++++      +     +++
++++++        a  +++
+++++++      A   +++
+++++++++         ++
++++++++++ +      ++
++++++++++++  ++  ++
+++++++++++++ ++++++
++++++++++++++++++++
