++++++++++++++++++++
++++++++++++++++++++
+++++++  +++++++  ++
+++++++  +++++++   +
+++++++            +
+++++++            +
+++++++      A++   +
++++++         +   +
++++++  ++++       +
++++++       a     +
++++++             +
++++++ 0+++++++    +
+++  +++++++++++   +
++++  +++++  ++++  +
++++   ++++  ++++  +
+++++   +++  ++++  +
++++++   ++  ++++  +
+++++++      ++++  +
+++++++++   ++++++++
++++++++++++++++++++
