++++++++++++++++++++
++++++++++++++++++++
++++++++        ++++
++++++++0   A   ++++
++++++++     +  +  +
+++  +++ a +    +  +
+++   ++   +       +
+++   ++   +       +
+++   +++  +  +    +
+++   +++   +++    +
+++   ++++   ++    +
+++   +++++  ++    +
+++   ++++++  +    +
+++   ++++++  ++  ++
+++   ++++++  ++  ++
+++   ++++++  ++  ++
+++     ++++  ++   +
+++++     ++       +
+++++++  ++++     ++
++++++++++++++++++++
