++++++++++++++++++++
++++++++++++++++++++
++++++++++         +
++++++++++         +
++++++++++  +++    +
++++++++++  +++++  +
+++++++++++++++++  +
+++++++++++++++++  +
++++++++++++++++   +
+++++++++++++++    +
++++++++++++++++   +
++++++++++++++++   +
++++++++++++++++   +
++++++++++++++++   +
++++++++++++++  +  +
+++++++++++a0      +
+++++++++ A        +
++++++++++   ++    +
+++++++++++ ++++  ++
++++++++++++++++++++
