++++++++++++++++++++
++++++++++++++++++++
+++++   +    +  ++++
+++++A          ++++
+++++    +    +  +++
+++++    +    +  +++
+++++++  +   a+    +
+++++++  +        ++
+++++++  +        ++
+++++++  +         +
+++++++  +         +
+++++++            +
+++++++            +
+++++++            +
+++++++      ++    +
+++++++0    ++++   +
++++++++  + +++++  +
++++++++  +++++++  +
++++++++++++++++++++
++++++++++++++++++++
