++++++++++++++++++++
++++++++++++++++++++
++++++    ++++++++++
++++++    ++++++++++
++++++    ++++++++++
++++++    +++++++  +
++++   +  +++++++  +
+++++  ++  ++++++  +
+++++++++    +++   +
++++++  +  0 +++   +
++++++  +    ++Aa  +
++++++        +    +
++++++             +
++++++             +
++++++            ++
+++++++           ++
++++++++    +++  +++
++++++++    +++  +++
++++++++++++++++++++
++++++++++++++++++++
