++++++++++++++++++++
++++++++++++++++++++
+++++ 0 +   ++++   +
++ ++       ++++   +
++    Aa           +
++     ++          +
++    ++           +
++    +++   +++++  +
+++ +++++   +++++  +
++++++++++  +++++  +
++++++++   ++++++  +
++++++++   ++++++  +
++++++++     ++++  +
++++++++      +++  +
++++++++      +++  +
++  ++++          ++
+++  +++++        ++
+++        +  ++++++
++++       +++++++++
++++++++++++++++++++
