++++++++++++++++++++
++++++++++++++++++++
++++++++++         +
++++++++++         +
++++++       ++ +  +
++++++             +
++++++  ++++ 0     +
++++++  +++++++++  +
++++++   ++++++++  +
+++++++  ++++++++  +
++  +++A ++++++++  +
++       ++++++++ ++
++++     +++++++++++
+++++++  +++++++++++
+++++++  +++++++++++
+++++++   a    +++++
++++++++       +++++
+++++++++++  +++++++
++++++++++++++++++++
++++++++++++++++++++
