++++++++++++++++++++
++++++++++++++++++++
++++++++++++++++++++
++   0  ++++  ++++++
+++     ++++  ++++++
++++++  +     ++++++
++++++  +     ++++++
++++++    A     ++++
++++++    +     ++++
++++++    +  a  +  +
++++++         ++  +
+++++++++          +
++++++++           +
+++++++++          +
+++++++++++        +
+++++++++++        +
++++++             +
+++++++            +
+++++++++++++     ++
++++++++++++++++++++
