++++++++++++++++++++
++++++++++++++++++++
+++   a       +  +++
++               +++
+++   ++++       +++
++++  ++++     +++++
+++++  ++++       ++
+++++             ++
++++++             +
+++ +++++   +  ++  +
+++  ++++   +  ++  +
+++         + +++  +
+++         +++++  +
+++   ++++ A+++++  +
++++  ++++  +++++  +
++++++++++   0    ++
+++++             ++
++++++      ++++++++
++++++++++++++++++++
++++++++++++++++++++
