++++++++++++++++++++
++++++++++++++++++++
++       +++++++++++
+++  a    +++++++  +
++++   +   ++++++  +
+++++  +    +++++  +
+++++       +++++  +
+++++      A       +
++++++     +       +
+++++++    ++++++  +
+++++++    +++  +  +
+++++++    ++++    +
+++++      ++++  +++
+++++     +++++   ++
+++++  +   0+++    +
+++++  +           +
+++++  +           +
+++++  +  +++++    +
+++++++++++++++++ ++
++++++++++++++++++++
