++++++++++++++++++++
++++++++++++++++++++
++++++++++     +++++
+++++  +++      ++++
++++   +++ a +  ++++
++++          +   ++
++++          +    +
+++++         +++  +
+++++  ++++    ++  +
++    ++++ ++   +  +
+++A 0++++  +   +  +
++++++++++  +      +
++++++++++  +      +
++++++++++  +  ++  +
++++++++++  +++++  +
++++++++++  ++++   +
++++++++++  ++     +
++++++++++         +
+++++++++++    ++ ++
++++++++++++++++++++
