++++++++++++++++++++
++++++++++++++++++++
+++++++  + 0++     +
+++++++     ++     +
++++++             +
++      +   a   +  +
+++     ++++      ++
++++++            ++
+++++ +           ++
+++++             ++
++++++     +  +   ++
++++++++++++  ++   +
++++++++++++  ++   +
++++++++++++  ++A  +
+++++        +++   +
+++++        +++   +
+++++ ++++++++++   +
++++++++++++++++   +
+++++++++++++++++ ++
++++++++++++++++++++
