++++++++++++++++++++
++++++++++++++++++++
+++++++++++        +
+++++++++++        +
++++++++++  A      +
++++++++++    ++   +
++++++++++  + +++  +
++             ++  +
+++         a 0    +
++++++++++++       +
+++++++++++++      +
+++++++++++++++++  +
+++++++++++++++++  +
+++++++++++++++++  +
+++++++++     +++  +
++++++++++     ++  +
+++++++++++++  ++  +
+++++++++++++      +
++++++++++++++    ++
++++++++++++++++++++
