++++++++++++++++++++
++++++++++++++++++++
++    +    +   +++++
++    +        +++++
++    +        +++++
++    +A       +++++
++ +  +        +++++
++++  ++           +
++++  +++          +
++++    +   +  +   +
+++++      ++  ++  +
+++++      ++  ++  +
+++++  +   ++  ++  +
+++    ++  ++a ++  +
++++0  ++++++  +   +
+++++  ++++++     ++
+++++            +++
++++++           +++
++++++++++++++  ++++
++++++++++++++++++++
