++++++++++++++++++++
++++++++++++++++++++
+++   ++++       +++
+++   +++        +++
+++              +++
+++            +   +
+++  ++++0 +++++   +
+++  ++++  +++++   +
+++  ++++  ++++++  +
+++    ++A ++++++  +
+++++  ++   +++++  +
+++++   +    ++++  +
+++++   + +        +
+++++   ++++       +
+++++ a +++++++++  +
++++    ++++  +++  +
+++++   ++    +++  +
+++++             ++
+++++++    ++     ++
++++++++++++++++++++
