++++++++++++++++++++
++++++++++++++++++++
++++++++++++  +   ++
++++++++++++       +
++++++++++++    +  +
++++++++        +  +
++++++++        +  +
++++++++  +     +  +
++++++++ ++    A   +
++++++++++++       +
++++++++           +
++       a         +
+++        +       +
+++    +           +
+++    ++  +       +
+++   +++          +
+++ 0 +++       + ++
+++  ++++       ++++
++++++++++++++ +++++
++++++++++++++++++++
