++++++++++++++++++++
++++++++++++++++++++
++++++++++++++++++++
+++++++++++++++    +
++++++++0 +++      +
++++++++           +
++++++             +
+++++++   ++       +
+++++++++    A     +
+++++++++          +
++++++++++         +
++++++++++  +++    +
++++++++++  +++    +
++++++++++  +++++  +
++++++++++  a++++  +
++++++++++    +++  +
++++++++   +  +++  +
++++++++   +       +
+++++++++++++     ++
++++++++++++++++++++
