++++++++++++++++++++
++++++++++++++++++++
+++++++++++++  ++  +
+++++++++++++  ++  +
+++++++++++++   a  +
++++++++++         +
++++++++++      +  +
+++++++++++     +  +
++++++++++++++  +  +
++++++++++++++     +
++++++++++++++  +  +
++++++++++++++     +
++++++++++++++     +
+++++ +++          +
+++++  +           +
+++++   0A +++     +
++++++     +++   +++
++++++++   +++   +++
+++++++++ ++++++++++
++++++++++++++++++++
