++++++++++++++++++++
++++++++++++++++++++
++++  ++++++++++++++
++++  ++++  ++++++++
++    +      +++++++
+++   +      +++++++
+++          +++++++
+++          +++++++
+++       +0  +++  +
+++           +++  +
+++   +       ++   +
+++A  ++  +        +
++++  ++  ++       +
++++  ++  ++++     +
++ a  ++  +++++   ++
+++    +  +++++    +
++++      +++++++  +
++++     ++++++++  +
+++++  + +++++++++++
++++++++++++++++++++
