++++++++++++++++++++
++++++++++++++++++++
+++++++++++++++++  +
+++++++++++++++++  +
+++++++++++++++++  +
++++++++++++++++   +
+++++++++++++  +   +
+++++++++++++   A  +
++++++++++++       +
++++++++++++       +
++++++++++++       +
++++++++++++   a   +
+++++++++          +
++++++++++         +
++++++++++++0 ++   +
++++++++++++++++   +
++++++++++++++ +   +
++++++++++++++     +
+++++++++++++++   ++
++++++++++++++++++++
