++++++++++++++++++++
++++++++++++++++++++
++++++++++++++++  ++
+++++++++++++      +
+++++++++++++      +
++++++++++++++     +
++++++++++++++     +
+++++++++++++++    +
++++++++++++++++   +
+++++  +++++++++   +
+++++  ++   ++++   +
+++++              +
+++++              +
+++++      0   +   +
+++++   A+     +  ++
+++++          +  ++
+++++      a   +  ++
+++++    +++  ++  ++
++++++++++++++++++++
++++++++++++++++++++
