++++++++++++++++++++
++++++++++++++++++++
+++++     +++++++  +
+++++     +++++++  +
+++++     +++++++  +
++++++    +++++++  +
++++++++  +++  ++  +
++++++++   A       +
+++++              +
+++++        ++++  +
+++++        ++++  +
++++++    +++++++  +
+++++    +++++++   +
+++++  a +++++++   +
++++++    0+++     +
++++++  +          +
+++++++  ++        +
+++++++     ++++   +
++++++++    ++++++++
++++++++++++++++++++
