++++++++++++++++++++
++++++++++++++++++++
++++++++++++++     +
+++++++++++++++    +
+++++++++++++++    +
++++++++++++++++   +
+++  A  +++++++++  +
+++      ++++++++  +
++  +++  ++++++++  +
+++ +++  ++++++++  +
+++++++  ++++++ +  +
+++++++  +         +
+++++++0a+         +
+++++++  +  +++    +
++++ ++  +  +++    +
++++  +            +
++++  ++           +
++++        +++    +
+++++      +++++  ++
++++++++++++++++++++
