++++++++++++++++++++
++++++++++++++++++++
++++++++           +
+++++  +           +
+++++     +++++++  +
+++++     +++++++  +
+++++a    +++++++  +
++++++    ++++++   +
++++++    ++++++   +
++++++    ++++++   +
++++++    ++++++   +
++++++  ++++++++   +
++++++   + +++++   +
++++++   +         +
++++++   ++   A    +
++++++ 0 +++++     +
+++++++  +++++    ++
+++++++  +++++++++++
++++++++++++++++++++
++++++++++++++++++++
