++++++++++++++++++++
++++++++++++++++++++
++++++++++++  +++  +
++++++++++    +++  +
+++++++++         ++
+++++++++         ++
+++++++++      ++  +
+++        A  +++  +
+++                +
+++ +   +          +
++      +  +  +++  +
++      +  +  +++  +
++  +   +  ++++    +
++  +     ++++++   +
++  +  a0 +++++++  +
++  +    ++++++++  +
++ +++ ++++++++++  +
+++++++++++++++++  +
++++++++++++++++++++
++++++++++++++++++++
