++++++++++++++++++++
++++++++++++++++++++
+++++++++  +++++   +
+++++++++  ++      +
+++++++++0 ++   a  +
+++++++++  ++  +   +
+++++++++  ++  +   +
++++++++++  +      +
++++++++++         +
++++++++++   A     +
++++++++++  +  ++  +
++++++++++  +  ++  +
++++++++++  +  ++  +
+++++++++  ++ +++  +
++++++++   ++     ++
+++++++    +      ++
+++++++    +    +  +
+++++++            +
++++++++++        ++
++++++++++++++++++++
