++++++++++++++++++++
++++++++++++++++++++
+++++++++++++      +
+++++++++++++     ++
+++++++++++   ++++++
++++++  +++   ++++++
++++++  ++++++  ++++
++++++     +++  ++++
++++++       a  ++++
+++++   +++    +++++
++++++  ++++++++++++
++++++  +++++++ A+++
++++++  +++++++    +
++++++        +   ++
+++                +
++++  0            +
++++               +
+++++ +++++++      +
++++++++++++++    ++
++++++++++++++++++++
