++++++++++++++++++++
++++++++++++++++++++
+++++++++++++++++  +
+++++++++++++++++  +
+++++++++++0       +
++++++    +        +
+++++++   +        +
+++++        A     +
++++++             +
+++           +++  +
+++    a ++  ++++  +
+++  +  +++  ++++  +
+++ ++  +++  ++++  +
++++++  +++   +++  +
++++++  +++   +++  +
++ +++  +++        +
++                 +
++                ++
+++ ++++++++      ++
++++++++++++++++++++
