++++++++++++++++++++
++++++++++++++++++++
++         ++   +  +
+++    a           +
+++    +++   A    ++
+++    +++++++    ++
+++       +++++    +
+++       +        +
+++  +++    0      +
+++  ++++    ++    +
+++ ++++++ ++++    +
++++++  ++  +++    +
++++++  ++  +++    +
++++++  ++  +++   ++
++++++  ++  +++   ++
++++++  ++  +++  +++
++++++  ++       +++
++++++           +++
+++++++    +++++++++
++++++++++++++++++++
