++++++++++++++++++++
++++++++++++++++++++
+++++++A   ++++++  +
+++++++    ++++++  +
+++++++++  ++++++  +
+++++++++          +
+++++++++          +
+++++++++a    ++   +
+++++++++       +  +
+++++++++          +
+++++++ +++        +
+++++++     +      +
+++++++     +      +
+++++++++++++  +  ++
+++++++++++++  ++  +
+++++++++++++  ++  +
+++++++++++++ 0    +
+++++++++++++      +
+++++++++++++++++ ++
++++++++++++++++++++
