++++++++++++++++++++
++++++++++++++++++++
+++++              +
+++++              +
++       ++    0A  +
+++      +++++     +
+++++   +++++++    +
+++++  ++++++++    +
+++++++++++++++ a  +
++++++++++++++++   +
+++++++++++++++++  +
++++++             +
++++++             +
++++++  ++++++++   +
+++++++++++++++++  +
+++++++++++++++++  +
+++++++++++++++++  +
+++++++++++++++++ ++
++++++++++++++++++++
++++++++++++++++++++
