++++++++++++++++++++
++++++++++++++++++++
++++     ++        +
+++++              +
+++++++++ 0  +     +
++++++++++     ++  +
++++++++++  ++ ++  +
++++ ++++A         +
++++  +++ a        +
+++   +++  +++++   +
+++   +++  +++++   +
+++   +++  +++++   +
+++    ++  +++++   +
+++    ++  +++++   +
++++   ++  +++++   +
++++   ++  +++++  ++
++++       ++++++ ++
++++       +++++++++
+++++     ++++++++++
++++++++++++++++++++
