++++++++++++++++++++
++++++++++++++++++++
++++++   +++++++   +
++++++             +
++++++             +
++++++   +         +
++++++   +  a++++  +
++++++   + A+++++  +
++++++   ++   +++  +
+++++    +++    0  +
+++++              +
+++++           +  +
+++++  ++++        +
+++++  ++++        +
+++++  +++++  +++  +
++++++++++++  +++ ++
++++++++++++ +++++++
++++++++++++++++++++
++++++++++++++++++++
++++++++++++++++++++
