++++++++++++++++++++
++++++++++++++++++++
+++++++++++        +
++++++++++++       +
+++++++++++++++++  +
+++++++++++++++++  +
++++++++++  +++++  +
++++++++++         +
++++++++0          +
+++++++++      +++++
++++++++++++    ++++
+++  ++++++++      +
++++  +            +
++++  +     A      +
++++  +  ++++++    +
++++  +  ++++++    +
++++  + a++++++    +
++++    +++++++    +
+++++   ++++++++  ++
++++++++++++++++++++
