++++++++++++++++++++
++++++++++++++++++++
++++++++  +  +++   +
++++++++  +  ++++  +
++++++++     ++++  +
++++++++     ++++  +
++++++++  + A++++  +
+++++++   +  ++++  +
+++++++   +  ++++  +
++                 +
++            a    +
+++++++0 ++        +
+++++++ +++++      +
++++++++++++++++  ++
++++++++++++++++  ++
++++++++++++++++  ++
++++++++++++++++  ++
++++++++++++++++  ++
++++++++++++++++++++
++++++++++++++++++++
