++++++++++++++++++++
++++++++++++++++++++
++++     +++A ++++++
++++     ++     ++++
++++     ++      +++
++++     ++      +++
++        +      +++
++          +    +++
++      a     +  +++
++  +      ++ +   ++
++  +      ++++    +
++  +   +  ++++    +
++      +  ++++++  +
++     ++ 0 +++++  +
+++++++++   +++++  +
+++++++++  ++++++  +
++++++++++ ++++++  +
+++++++++++++++++  +
++++++++++++++++++++
++++++++++++++++++++
