++++++++++++++++++++
++++++++++++++++++++
+++++++++++++  ++  +
+++++++++++++      +
+++++++++++++  +   +
+++++++++++++   a  +
+++++++++++++      +
+++++++++++++      +
++++++++ A+        +
++++++++  ++   +   +
++++++++        +  +
+++++ ++0       +  +
+++++  +  +++      +
+++++  +  +++      +
+++++  +  +++      +
+++++  +  ++++ ++  +
+++++     +++++++  +
++++++   ++++++++  +
++++++++++++++++++++
++++++++++++++++++++
