++++++++++++++++++++
++++++++++++++++++++
+++++++++++++++++  +
+++++++++++++++++  +
++++++++++++++++   +
++++++++++++++++   +
++++++++++         +
+++++++++++        +
+++++++++++        +
+++++++++ +  +++   +
+++++++++    +++  ++
+++++++++    +++  ++
+++++++      +++   +
+++++++  A    ++   +
+++  ++  a    +++  +
+++     0+    +++  +
+++      +++  +++  +
+++   ++++++      ++
+++++++++++++     ++
++++++++++++++++++++
