++++++++++++++++++++
++++++++++++++++++++
++++++++  +++++    +
++++++++  +++++    +
++++++++  +++++ a  +
++++++++  +        +
++++++++           +
+++++ A+           +
+++++  +           +
+++++ 0 +          +
+++++   +          +
+++++     +  +++   +
+++++++   +  ++++  +
+++++++++++  +++++++
++++++++++++++++++++
++++++++++++++++++++
++++++++++++++++++++
++++++++++++++++++++
++++++++++++++++++++
++++++++++++++++++++
