++++++++++++++++++++
++++++++++++++++++++
++++  ++++   +++++++
++++   +++  0+++++++
+++              +++
++++               +
+++++ a  ++        +
++++++         A   +
++++++++    +      +
++++++++  +++      +
+++       ++       +
+++        +      ++
+++ ++++         +++
+++++++++          +
++++++++           +
++++++++           +
++++++++++         +
+++++++++++        +
+++++++++++++++++ ++
++++++++++++++++++++
