++++++++++++++++++++
++++++++++++++++++++
+++  +  0          +
+++  +    A        +
+++  +      +  ++  +
+++  +  ++     ++  +
++   +  ++  +  ++  +
+++     ++  +  ++  +
+++     ++        ++
+++ a+  +++        +
+++  +  +++        +
+++++  ++++++      +
++++   +++++++  +  +
+++++  ++++++++++  +
+++++++++++++++++  +
+++++++++++++++++  +
+++++++++++++++++  +
+++++++++++++++++  +
++++++++++++++++++++
++++++++++++++++++++
