++++++++++++++++++++
++++++++++++++++++++
+++    0          ++
++        A        +
++    +  +  +   a  +
++   +++++    +    +
++      ++         +
+++                +
++++  +            +
++++  +  +  ++     +
++++  +  +  ++++   +
++++  +  +  +++++  +
++++ +++   ++++++  +
+++++++++  ++++++  +
+++++++++++++++++  +
+++++++++++++++++  +
+++++++++++++++++  +
+++++++++++++++++  +
+++++++++++++++++ ++
++++++++++++++++++++
