++++++++++++++++++++
++++++++++++++++++++
+++++++   ++++++   +
++++++0    +++++   +
++++++  +  +++++   +
+++                +
++++               +
++++++             +
++++++  ++++       +
++++++  ++++      ++
+++++   +++   +    +
+++++ A +++   ++   +
+++++   a     ++   +
+++++              +
+++++   ++++      ++
+++++   ++++  +   ++
++++++  ++++  +   ++
++++++++++++      ++
+++++++++++++   ++++
++++++++++++++++++++
