++++++++++++++++++++
++++++++++++++++++++
++ +++  +      ++  +
++  ++             +
++ 0++    +        +
++  ++ A       ++  +
++  ++       a     +
++  ++    +        +
++  ++   ++        +
++     ++++     +  +
+++    +++++  +++  +
++++++++++++  +++  +
++++++++++++++++++++
++++++++++++++++++++
++++++++++++++++++++
++++++++++++++++++++
++++++++++++++++++++
++++++++++++++++++++
++++++++++++++++++++
++++++++++++++++++++
