++++++++++++++++++++
++++++++++++++++++++
+++++++++++++++++  +
+++++++++++++++++  +
++++++++++++++     +
+++++++++    +     +
+++++++++          +
+++++++++ 0+ a  +  +
++++++  +  +    +  +
++++++  +  ++   +  +
++++++    +++      +
++++++  A ++       +
++++++  ++++    +  +
++++++  ++++++  +  +
++++++ +++++++     +
++++++++++  ++     +
++++++++        +  +
+++++++++         ++
+++++++++++++++   ++
++++++++++++++++++++
