++++++++++++++++++++
++++++++++++++++++++
+++++++++  0       +
+++++++++          +
++++++++a      ++  +
+++++++++          +
++++++++++         +
+++++++++      A   +
++++++++++         +
+++++++++++  ++ +  +
+++++++++++  ++++  +
++++++++++++++     +
++++++++++++++     +
+++++++++++++++++  +
+++++++++++++++++  +
+++++++++++++++++  +
+++++++++++++++++  +
+++++++++++++++++  +
++++++++++++++++++++
++++++++++++++++++++
