++++++++++++++++++++
++++++++++++++++++++
++++++++++++++     +
++++++++++++++     +
+++++++++  +++     +
++++++++++  ++     +
++++++++++      a  +
++++++++++      +  +
+++++++++++     +  +
+++++++A  0  ++++  +
+++++++      +++++++
++++++  +++++++++  +
+++++++ +++++++++  +
+++++++++++++++++  +
+++++++++++++++++  +
+++++++++++++++++  +
+++++++++++++++    +
+++++++++++++++    +
++++++++++++++++  ++
++++++++++++++++++++
