++++++++++++++++++++
++++++++++++++++++++
+++++++++++++    +++
+++++++++++++    +++
++++++           +++
++++++            ++
++++++  ++++++     +
+++++  +++++++0 +  +
+++++  +++++++     +
+++++  +++++++++   +
+++++  +++++++++   +
+++++   ++++++++   +
+++++   ++  +++++  +
++++    +   ++++   +
++ +        ++++a  +
++   +    A ++++   +
++   +++++  +++    +
++  ++++++      +  +
+++++++++++     ++++
++++++++++++++++++++
