++++++++++++++++++++
++++++++++++++++++++
+++++++++++++++++  +
+++++++++++    ++  +
++++++++++++    +  +
++++++++++++++  +  +
++++++++++++++  +  +
++++++++++++++     +
+++++   aA   0     +
++++++             +
++++++ ++++++++++  +
++++++  ++++++++   +
++++++  +++++      +
++++++  +++++      +
++++++        ++   +
+++++++       +++  +
++       +  +++++  +
+++         +++++  +
+++++++++  ++++++ ++
++++++++++++++++++++
