++++++++++++++++++++
++++++++++++++++++++
++  +    ++++++    +
++      +++++++    +
++  0a ++++++++    +
++   +++++   ++    +
++  +++++++        +
+++                +
++++          +    +
++++++++  ++       +
++++++++  ++       +
++++     A++++  +  +
++++           ++  +
+++++++        ++  +
++++++++   ++++++  +
+++++++++  ++++    +
+++++++++          +
++++++++++      +  +
++++++++++++++++++++
++++++++++++++++++++
