++++++++++++++++++++
++++++++++++++++++++
+++++   +++   ++++++
+++++         ++++++
+++++  +        +  +
+++++  +++++    +  +
+++++  +++++ 0  +  +
++++   +++++  +++  +
++++   +  a   +++  +
++++               +
++ ++      +       +
++  +      +  +++  +
++  +  A   +  +++  +
++  +   +  +       +
++  +  +++++  +    +
++    +++++  ++++  +
++    ++++++ ++++  +
++  +++++++++++++  +
++++++++++++++++++++
++++++++++++++++++++
