++++++++++++++++++++
++++++++++++++++++++
+++++++    +++++++++
+++++       ++++++++
+++++          +++++
+++++        0 +++++
+++++         ++++++
++++++ A           +
++++++       +     +
++++++  +    ++++  +
+++++++++    ++    +
+++++++++    ++    +
+++++++++a   ++    +
+++++++++          +
++++++++++         +
+++++++++++        +
+++++++++++++      +
+++++++++++++   +  +
++++++++++++++  ++++
++++++++++++++++++++
