++++++++++++++++++++
++++++++++++++++++++
+++ ++  +++++  +++++
+++  +  +++++  ++  +
+++                +
+++           a    +
+++  A+        ++  +
+++   +++     +++  +
+++   +++++   +++  +
+++   +++++   +++  +
+++   +++++   +++  +
+++   ++++   ++++  +
+++   ++++   +++   +
+++   ++++ 0       +
+++   ++++         +
++++  ++++   +++   +
++++++++++    ++   +
+++++++++++        +
+++++++++++++     ++
++++++++++++++++++++
