++++++++++++++++++++
++++++++++++++++++++
++++++++      ++++++
+++++++++     ++++++
++++++++++ 0  ++++++
++++++++++     +++++
++++++++++       +++
+++++++++++      +++
+++++++++++      +++
+++++++++++aA    +++
+++++++  ++      +++
+++++++   +      +++
++++            +  +
+++++              +
+++++++   +        +
+++++++   ++++  +  +
+++++++     ++  +  +
+++++++        ++  +
++++++++ +++   ++ ++
++++++++++++++++++++
