++++++++++++++++++++
++++++++++++++++++++
+++++++++++++++++  +
+++++++++++++++++  +
+++++++++++++++++  +
+++++++++++        +
++++++++           +
++++++++    0      +
++++++++           +
++++++++  ++A      +
++++++++     a     +
+++++++++++        +
+++++++++++++      +
+++++++++++++      +
++++++++++++++++   +
+++++++++++++++++  +
+++++++++++++++++  +
+++++++++++++++++  +
++++++++++++++++++++
++++++++++++++++++++
