++++++++++++++++++++
++++++++++++++++++++
+++++++++++  ++  +++
+++++++++++0 ++  +++
++++  +++++  ++  +++
++++  +++++     ++++
++++  ++++      ++++
++++  ++++       +++
++++  ++++        ++
++++  +A+++  +++  ++
+++      +   +++   +
++++ a   +   ++++  +
++++++       ++++  +
++++++        +++  +
++++++  ++     ++  +
++++++             +
+++++++            +
+++++++++       +  +
++++++++++     ++ ++
++++++++++++++++++++
