++++++++++++++++++++
++++++++++++++++++++
+++++  ++++++++    +
+++++  ++++++++    +
+++++  +++++++  +  +
+++++  ++++     +  +
+++++  ++++        +
+++++  ++    a A   +
+++++  +           +
+++++              +
++++++    +++      +
++++++++  ++++  +  +
++++++++    +++++  +
++++++++    +++++  +
+++++++++          +
+++++++   0        +
++++++++      +++  +
++++++++    ++++++++
+++++++++ ++++++++++
++++++++++++++++++++
