++++++++++++++++++++
++++++++++++++++++++
+++++++++++++      +
+++++++++++++      +
+++++++++++++  ++  +
+++++++++++++  +   +
+++++++++++++ ++   +
+++++++++   ++++   +
+++++++++       +  +
+++++++++       0  +
+++++++     +++    +
+++++++     +++    +
++++++++   A+++ a  +
++++++++           +
++++++++           +
++++++++   +++++   +
+++++++++  ++++++  +
++++++++++++++++++++
++++++++++++++++++++
++++++++++++++++++++
