++++++++++++++++++++
++++++++++++++++++++
++++++++++++       +
++++++++++++      ++
++++++++++++  +  +++
+++  +++++    +  +++
++++  +++     +  +++
++++  +++        +++
++++            ++++
+++++           ++++
++++++++++  +     ++
+++++++  +    ++   +
+++++++       +++  +
+++++++ 0    ++++  +
+++++++  ++++++++  +
++++A    +  +  ++  +
+++++a             +
++++++++++    +    +
+++++++++++++++++ ++
++++++++++++++++++++
