++++++++++++++++++++
++++++++++++++++++++
+++++++    +++     +
+++++   a          +
++             +   +
+++         A      +
+++++++  +         +
+++++++  +++++++   +
+++++++            +
++++++++           +
+++++++++++++++++  +
++++++++++++       +
+++++++++++++      +
++++++++++++++  +  +
++++++++++      +  +
+++++++++++ 0   +  +
+++++++++++++      +
+++++++++++++      +
++++++++++++++ +++++
++++++++++++++++++++
