++++++++++++++++++++
++++++++++++++++++++
+++++++++++++  +++++
+++++++   +++  ++  +
+++++++        ++  +
+++  ++           ++
+++                +
+++  0          +  +
+++  +          +  +
+++  +             +
++   +  ++   a    ++
++   +A ++         +
+++          ++    +
++++         ++++  +
+++++++++++  ++++  +
+++++++++++  ++++  +
+++++++++++       ++
+++++++++++       ++
++++++++++++++++++++
++++++++++++++++++++
