++++++++++++++++++++
++++++++++++++++++++
++++++a   ++   +++++
++++     A     +++++
++++              ++
++++               +
++++++      +++++  +
++  ++      +++++  +
+++         +++++  +
++++    ++  +++++  +
+++++   ++ 0+++++  +
+++++   ++  +++++  +
+++++   ++        ++
+++++             ++
+++++        +    ++
+++++        +    ++
++     +++      ++++
+++    +++     +++++
++++++++++++++++++++
++++++++++++++++++++
