++++++++++++++++++++
++++++++++++++++++++
+++++++++++++++++  +
+++++++++++++++++  +
+++++++++++++++++  +
++++++++++++++++   +
+++++++++++++      +
+++++++++++++      +
+++++++++++++  +   +
+++++++++  aA      +
++++               +
+++   0   +++  +   +
++++ ++++++++  +   +
+++++  ++++++ ++   +
+++++   ++++++++  ++
+++++   ++++++++  ++
+++++   ++++       +
+++++             ++
+++++++      +    ++
++++++++++++++++++++
