++++++++++++++++++++
++++++++++++++++++++
+++++++   ++++++++++
+++++++   +++++++  +
++++++++  +++++++  +
++++++++  +++++++  +
++++++++  +++++++  +
+++  +++  +++++    +
++++  ++  +++++    +
++++  +++++++++ +  +
++++  ++++  +++++  +
++++         ++++  +
++++               +
++++   +   0       +
++++  ++       ++  +
++++        A   +  +
+++++    a         +
++++++++   ++      +
+++++++++ +++++   ++
++++++++++++++++++++
