++++++++++++++++++++
++++++++++++++++++++
+++++++++++++++++  +
+++++++++    ++++  +
+++++++++0  a++++  +
+++++++++    ++++  +
+++++++++ +        +
++++++++++++  A    +
+++++++++++++++++  +
+++++++++++++++++  +
+++++++++++++++++  +
+++++++++++++++++ ++
++++++++++++++++++++
++++++++++++++++++++
++++++++++++++++++++
++++++++++++++++++++
++++++++++++++++++++
++++++++++++++++++++
++++++++++++++++++++
++++++++++++++++++++
