++++++++++++++++++++
++++++++++++++++++++
+++++++++++++++++  +
+++++++++++++   A  +
+++++++++++++      +
++++++++++++  +++  +
++++++++++++  +++  +
+++++++++++a ++++  +
++++++++++++0++++  +
+++++++++++++++++  +
+++++++++++++++++  +
+++++++++++++++++  +
+++++++++++++++++  +
+++++++++++++++++  +
+++++++++++++++++  +
+++++++++++++++++ ++
++++++++++++++++++++
++++++++++++++++++++
++++++++++++++++++++
++++++++++++++++++++
