++++++++++++++++++++
++++++++++++++++++++
+++++++++++++   ++++
+++++++++++++    +++
+++++++++++++   0+++
+++++++++++++   a+++
+++++++++++++    +++
+++++++++++++    +++
+++++++++++++    +++
+++++++++++++  +++++
+++++++++++++  +++++
++++++++++++ A +++++
++++++++++++  ++++++
++++++++++++  ++++++
++++++++++++++++++++
++++++++++++++++++++
++++++++++++++++++++
++++++++++++++++++++
++++++++++++++++++++
++++++++++++++++++++
