++++++++++++++++++++
++++++++++++++++++++
+++++++++++++++++  +
++++++++++    +++  +
++++++++++ 0  +++  +
++++++++++    +++  +
++++++++++         +
++++++++++  +      +
++++++++++  ++++++++
++++++++++ A++++++++
++++++++++ a++++++++
++++++++++  ++++++++
++++++++++ +++++++++
++++++++++++++++++++
++++++++++++++++++++
++++++++++++++++++++
++++++++++++++++++++
++++++++++++++++++++
++++++++++++++++++++
++++++++++++++++++++
