++++++++++++++++++++
++++++++++++++++++++
++++++++++++++++++++
++++++++++++++++++++
++++++++++++++++++++
++++++++++++++++++++
++++++++++++++++++++
+++++++++     ++++++
++++++++++   0 +++++
+++++++++++++  +++++
+++++++++++++ a+++++
+++++++++++++  ++  +
++++++++++++++ A   +
+++++++++++++++    +
+++++++++++++++++  +
+++++++++++++++++  +
+++++++++++++++++  +
+++++++++++++++++  +
+++++++++++++++++ ++
++++++++++++++++++++
