++++++++++++++++++++
++++++++++++++++++++
++++++++++++++++++++
++++++++++++++++++++
++++++++++++++   +++
++++++++++++++    ++
+++++++++         ++
+++++++++0        ++
+++++++++a +++ A  ++
+++++++++ ++++++  ++
++++++++++++++++  ++
+++++++++++++++++ ++
++++++++++++++++++++
++++++++++++++++++++
++++++++++++++++++++
++++++++++++++++++++
++++++++++++++++++++
++++++++++++++++++++
++++++++++++++++++++
++++++++++++++++++++
