++++++++++++++++++++
++++++++++++++++++++
++A    +++++++++++++
++      ++++++++++++
++   +  ++++++++++++
++a  +0 ++++++++++++
++++++  ++++++++++++
++++++    ++++++++++
+++++++    +++++++++
+++++++++  +++++++++
+++++++++  +++++++++
+++++++++  +++++++++
++++++++++++++++++++
++++++++++++++++++++
++++++++++++++++++++
++++++++++++++++++++
++++++++++++++++++++
++++++++++++++++++++
++++++++++++++++++++
++++++++++++++++++++
