++++++++++++++++++++
++++++++++++++++++++
+++++++       0    +
++++++   A         +
+++++  a+++++++++  +
+++++   ++++++++++++
+++++  +++++++++++++
+++++  +++++++++++++
++++++++++++++++++++
++++++++++++++++++++
++++++++++++++++++++
++++++++++++++++++++
++++++++++++++++++++
++++++++++++++++++++
++++++++++++++++++++
++++++++++++++++++++
++++++++++++++++++++
++++++++++++++++++++
++++++++++++++++++++
++++++++++++++++++++
