++++++++++++++++++++
++++++++++++++++++++
++++++++++++++++++++
++++++++++++++++++++
+++++++++++++++++  +
+++++++++++++++++  +
++++++++++++++++   +
++++++++++++++++   +
++++++++++++++++   +
++++++++++++++++   +
+++++++++++ ++++   +
+++++++++++  +++   +
+++++++++++     A  +
++++++++++++0a     +
+++++++++++++++++  +
+++++++++++++++++  +
+++++++++++++++++  +
+++++++++++++++++  +
+++++++++++++++++ ++
++++++++++++++++++++
