++++++++++++++++++++
++++++++++++++++++++
+++  ++  A  ++++++++
+++         ++++++++
++ a       0 +++++++
+++ ++++  +   ++++++
++++++++  ++  ++++++
++++++++++++++++++++
++++++++++++++++++++
++++++++++++++++++++
++++++++++++++++++++
++++++++++++++++++++
++++++++++++++++++++
++++++++++++++++++++
++++++++++++++++++++
++++++++++++++++++++
++++++++++++++++++++
++++++++++++++++++++
++++++++++++++++++++
++++++++++++++++++++
