++++++++++++++++++++
++++++++++++++++++++
++++++++++    0a   +
++++++++++A        +
++++++++++  ++++++++
+++++++++  +++++++++
+++++++++  +++++++++
+++++++++  +++++++++
+++++++++  +++++++++
+++++++++  +++++++++
+++++++++ ++++++++++
++++++++++++++++++++
++++++++++++++++++++
++++++++++++++++++++
++++++++++++++++++++
++++++++++++++++++++
++++++++++++++++++++
++++++++++++++++++++
++++++++++++++++++++
++++++++++++++++++++
