++++++++++++++++++++
++++++++++++++++++++
+++++++++++++++  +++
+++++++++++++++  +++
+++++++++++++++ a+++
+++++++++++++++  +++
+++++++++++++++  +++
+++++++++++      +++
+++++++++++      +++
++++++++    +++  +++
++++++++A   +++ 0+++
++++++++++++++++++++
++++++++++++++++++++
++++++++++++++++++++
++++++++++++++++++++
++++++++++++++++++++
++++++++++++++++++++
++++++++++++++++++++
++++++++++++++++++++
++++++++++++++++++++
