++++++++++++++++++++
++++++++++++++++++++
++++++++++++++++++++
++++++++++++++++++++
++++++++++++++++++++
++++++++++++++++++++
++++++++++++++++++++
++++++++++++++++++++
++++++++++++++++++++
++++++++++++++++++++
++++++++++++++++++++
++++++++++++++0 ++++
+++++  +++++++  ++++
+++++A +  ++++  ++++
+++++  +   +++  ++++
+++++      +++  ++++
+++++        a +++++
+++++  +++     +++++
++++++++++++++++++++
++++++++++++++++++++
