++++++++++++++++++++
++++++++++++++++++++
++++++++++++++++++++
++++++++++++++++++++
++++++++++++++++++++
++++++++++++++++++++
++++++++++++++++++++
++++++++++++++++++++
++++++++++++++++++++
++++++++++++++++++++
+++++++++++++  +++++
+++++++++++++     ++
+++++++++++++      +
+++++++++     +++  +
+++ 0  ++     +++  +
++++   ++ A+++++++++
+++++  ++ a+++++++++
+++++      +++++++++
++++++    ++++++++++
++++++++++++++++++++
