++++++++++++++++++++
++++++++++++++++++++
++++++++++++++++++++
++++++++++++++++++++
++++++++++++++++++++
++++++++++++++++++++
++++++++++++++++++++
++++ +++++++++++++++
++++  ++++++++++++++
++++    A   +++  +++
+++++0       ++   ++
+++++++++++   a    +
+++++++++++      +++
+++++++++++      +++
+++++++++++      +++
++++++++++++    ++++
+++++++++++++++ ++++
++++++++++++++++++++
++++++++++++++++++++
++++++++++++++++++++
