++++++++++++++++++++
++++++++++++++++++++
++  ++++++++  A ++++
+++             ++++
++++a        +  ++++
++++++++++++++  ++++
++++++++++++++  ++++
++++++++++++++ 0++++
++++++++++++++    ++
+++++++++++++++    +
+++++++++++++++++  +
+++++++++++++++++  +
+++++++++++++++++  +
+++++++++++++++++  +
+++++++++++++++++  +
+++++++++++++++++  +
+++++++++++++++++ ++
++++++++++++++++++++
++++++++++++++++++++
++++++++++++++++++++
