++++++++++++++++++++
++++++++++++++++++++
++++++++++++++++++++
++++++++++++++++++++
++++++++++++++++++++
++++++++++++++++++++
++++++++++++++++++++
++++++++++++++++++++
++++++++++++++++++++
+++++++++++++  +++++
+++++++++++++  +++++
+++++++++++++   ++++
+++++++++++++ 0  +++
+++++++++++++ A  +++
+++++++++++++    +++
+++++++++++++++  +++
+++++++++++++++a +++
+++++++++++++++    +
++++++++++++++++  ++
++++++++++++++++++++
