++++++++++++++++++++
++++++++++++++++++++
+++    +++++++++++++
+++ 0  +++++++++++++
+++++ A ++++++  ++++
++++++   +++    ++++
+++++++         ++++
++++++++       +++++
++++++++++++a ++++++
++++++++++++++++++++
++++++++++++++++++++
++++++++++++++++++++
++++++++++++++++++++
++++++++++++++++++++
++++++++++++++++++++
++++++++++++++++++++
++++++++++++++++++++
++++++++++++++++++++
++++++++++++++++++++
++++++++++++++++++++
