++++++++++++++++++++
++++++++++++++++++++
++++++++++    ++++++
++++++++++  0 ++++++
++++++++++ A     +++
++++++++++  +     ++
++++++++++  +++++  +
++++++++   ++++++  +
+++++++++a ++++++  +
++++++++++++++++++++
++++++++++++++++++++
++++++++++++++++++++
++++++++++++++++++++
++++++++++++++++++++
++++++++++++++++++++
++++++++++++++++++++
++++++++++++++++++++
++++++++++++++++++++
++++++++++++++++++++
++++++++++++++++++++
