++++++++++++++++++++
++++++++++++++++++++
++++++++++++++++++++
++++++++++      a ++
+++++++++         ++
+++++++++   ++++++++
+++++++     ++++++++
+++++++    +++++++++
+++++++ A+++++++++++
+++++++ 0+++++++++++
+++++++  +++++++++++
+++++++ ++++++++++++
++++++++++++++++++++
++++++++++++++++++++
++++++++++++++++++++
++++++++++++++++++++
++++++++++++++++++++
++++++++++++++++++++
++++++++++++++++++++
++++++++++++++++++++
