++++++++++++++++++++
++++++++++++++++++++
+++++++++++++++++  +
+++++++++++++++++  +
+++++++++++++++++  +
+++++++++++++a0    +
+++++++++++++A     +
+++++++++++++++++  +
++++++++++++++++++++
++++++++++++++++++++
++++++++++++++++++++
++++++++++++++++++++
++++++++++++++++++++
++++++++++++++++++++
++++++++++++++++++++
++++++++++++++++++++
++++++++++++++++++++
++++++++++++++++++++
++++++++++++++++++++
++++++++++++++++++++
