++++++++++++++++++++
++++++++++++++++++++
+++++++++++++++++  +
++++++++++++  +++  +
+++++++++a    +++  +
++++++++ A    +0  ++
++++++++  ++  +   ++
+++++    +++     +++
+++++    ++++    +++
+++++ ++++++++++++++
++++++++++++++++++++
++++++++++++++++++++
++++++++++++++++++++
++++++++++++++++++++
++++++++++++++++++++
++++++++++++++++++++
++++++++++++++++++++
++++++++++++++++++++
++++++++++++++++++++
++++++++++++++++++++
