++++++++++++++++++++
++++++++++++++++++++
++++++++++++++++   +
++++++++++++++++A  +
++++++++++++++++   +
++++++++++++++++   +
+++++++++++++++a0  +
+++++++++++++++    +
+++++++++++++++++  +
+++++++++++++++++  +
+++++++++++++++++  +
+++++++++++++++++ ++
++++++++++++++++++++
++++++++++++++++++++
++++++++++++++++++++
++++++++++++++++++++
++++++++++++++++++++
++++++++++++++++++++
++++++++++++++++++++
++++++++++++++++++++
