++++++++++++++++++++
++++++++++++++++++++
++++++++++++++++++++
++++++ +++++++++++++
++++++  +++++++  +++
++++++  +++++++  +++
++++++    +++++  +++
+++++++ 0     +  +++
++++++++++       +++
+++++++++++++ a  +++
++++++++++++++   +++
+++++++++++++++  +++
+++++++++++++++  +++
+++++++++++++++  +++
+++++++++++++++  +++
+++++++++++++++  +++
+++++++++++++++A +++
++++++++++++++++++++
++++++++++++++++++++
++++++++++++++++++++
