++++++++++++++++++++
++++++++++++++++++++
+++++++++++++    +++
++++++++++++++  A+++
+++++++++++++++  +++
+++++++++++++++ a+++
+++++++++++++++  +++
+++++++++++++++    +
++++++++++++++++0  +
+++++++++++++++++ ++
++++++++++++++++++++
++++++++++++++++++++
++++++++++++++++++++
++++++++++++++++++++
++++++++++++++++++++
++++++++++++++++++++
++++++++++++++++++++
++++++++++++++++++++
++++++++++++++++++++
++++++++++++++++++++
