++++++++++++++++++++
++++++++++++++++++++
++++++++++++++++++++
++++++++++++++++++++
++++++++++++++++++++
++++++++++++++++++++
++++++++++++++++++++
++++++++++++++++++++
++++++++++++++++++++
++++++++++++++++++++
++++++++++++++++++++
++++++++++++++++++++
+++++++0 +a     +  +
+++++++            +
+++++++     +++ A  +
+++++   +   +++    +
++++++  ++  +++    +
++++++++++++++++  ++
++++++++++++++++++++
++++++++++++++++++++
