++++++++++++++++++++
++++++++++++++++++++
+++++++++++ a0A    +
+++++++++++        +
+++++++++++  ++++  +
++++++++++  +++++  +
+++++++++++ +++++ ++
++++++++++++++++++++
++++++++++++++++++++
++++++++++++++++++++
++++++++++++++++++++
++++++++++++++++++++
++++++++++++++++++++
++++++++++++++++++++
++++++++++++++++++++
++++++++++++++++++++
++++++++++++++++++++
++++++++++++++++++++
++++++++++++++++++++
++++++++++++++++++++
