++++++++++++++++++++
++++++++++++++++++++
++++++++++++++++++++
++++++++++++++++++++
+++++++++++++++++  +
+++++++++++++++++  +
+++++++++++++++++  +
+++++++++++++++++  +
+++++++++++++++++  +
++++++++++++++++A  +
++++++++++++++++   +
++++++++++++++++a  +
++++++++++++++++  ++
++++++++++++++++0+++
++++++++++++++++++++
++++++++++++++++++++
++++++++++++++++++++
++++++++++++++++++++
++++++++++++++++++++
++++++++++++++++++++
