++++++++++++++++++++
++++++++++++++++++++
++++++++++++++++++++
++++++++++++++++++++
++++++++++++++++++++
++++++++++++++++++++
++++++++++++++++++++
++++++++++++++++++++
++++++++++  ++++++++
++++++++++   +++++++
++++++++++   +++++++
++++++++++     +++++
++++++++++  aA    ++
+++++++++++  +    ++
+++++++++++  +  ++++
+++++++++++  +  ++++
+++++++++++ 0+++++++
++++++++++++++++++++
++++++++++++++++++++
++++++++++++++++++++
