++++++++++++++++++++
++++++++++++++++++++
++++  ++++++++++++++
++++  ++++++++++++++
++++  ++++++++++++++
++++A ++++++++++++++
++++    ++++++++++++
++      ++++++++++++
++    a ++++++++++++
++++++  ++++++++++++
++++++  ++++++++++++
++++++  ++++++++++++
++++++ 0++++++++++++
++++++  ++++++++++++
++++++  ++++++++++++
++++++  ++++++++++++
++++++  ++++++++++++
++++++    ++++++++++
+++++++   ++++++++++
++++++++++++++++++++
