++++++++++++++++++++
++++++++++++++++++++
++++++++++++++++++++
++++++++++++++++++++
++++++++++++++++++++
++++++++++++++++++++
++++++++++++++++++++
++++++++++++++++++++
++++++++++++++++++++
++++++++++++++++++++
+++++++++++++++++  +
+++++++++++++++++  +
++++++++ ++++++++  +
++++++++  +++++++  +
++++++++0 +++++++  +
++++++++       A   +
+++++++++  a       +
+++++++++++++++++  +
++++++++++++++++++++
++++++++++++++++++++
