++++++++++++++++++++
++++++++++++++++++++
++++++++++++++++++++
++++++++++++++++++++
++++++++++++++++++++
++++++++++++++++++++
++++++++++++++++++++
+++++++++++++++++  +
+++++++++++++++    +
++++++++++++a      +
++++++++ +++0A   +++
++++++++  ++  +  +++
++++++++  ++  ++++++
++++++++     +++++++
+++++++++    +++++++
++++++++++++++++++++
++++++++++++++++++++
++++++++++++++++++++
++++++++++++++++++++
++++++++++++++++++++
