++++++++++++++++++++
++++++++++++++++++++
++++++++++++++++++++
++++++++++++++++++++
++++++++++++++++++++
++++++++++++++++++++
++++++++++++++++++++
++++++++++++++++++++
++++++++++++++++++++
++++++++++++++++++++
++ +++++++++++++++++
++ A++++++++++++++++
++ a++++++++++++++++
++  ++++++++++++++++
++       +++++++++++
+++  0    +++     ++
++++++++          ++
+++++++++      +++++
++++++++++++++++++++
++++++++++++++++++++
