++++++++++++++++++++
++++++++++++++++++++
++        a   A 0 ++
++                 +
+++  ++++++++  +++++
+++  +++++++++++++++
+++  +++++++++++++++
++++++++++++++++++++
++++++++++++++++++++
++++++++++++++++++++
++++++++++++++++++++
++++++++++++++++++++
++++++++++++++++++++
++++++++++++++++++++
++++++++++++++++++++
++++++++++++++++++++
++++++++++++++++++++
++++++++++++++++++++
++++++++++++++++++++
++++++++++++++++++++
