++++++++++++++++++++
++++++++++++++++++++
++++++++++++++++++++
++++++++++++++++++++
++++++++++++++++++++
++++++++++++++++++++
++++++++++++++++++++
++++++++++  ++++++++
++++++++   +++++++++
++++  ++   +++++++++
++++  ++  ++++++++++
++++  ++  ++++++++++
++++A    +++++++++++
++    a0 +++++++++++
+++    +++++++++++++
++++  ++++++++++++++
+++++ ++++++++++++++
++++++++++++++++++++
++++++++++++++++++++
++++++++++++++++++++
