++++++++++++++++++++
++++++++++++++++++++
++++++++++++++++++++
++++++++++++++++++++
++++++++++++++++++++
++++++++++++++++++++
++++++++++++++++++++
++++++++++++++++++++
++++++++++++++++++++
++++++++++++++++++++
++++++++++++++++++++
++++++++++++++++++++
+++++++++++++++++  +
++++++++++++ ++++  +
++++++++++++ A+    +
++++++++++++0a+    +
++++++++++++  +    +
++++++++++++    +  +
+++++++++++++   ++++
++++++++++++++++++++
