++++++++++++++++++++
++++++++++++++++++++
++++++++++++++++++++
++++++++++++++++++++
++++++++++++++++++++
++++++++++++++++++++
++++++++++++++++++++
++++++++++++++++++++
++++++++++++++++++++
++++++++++++++++++++
++++++++++++++++++++
++++++++++++++++++++
+++++++      +++++++
+++++++       ++++++
+++++++  +++ 0 +++++
++++++A a+++      ++
+++++++ ++++++     +
++++++++++++++  ++++
++++++++++++++++++++
++++++++++++++++++++
