++++++++++++++++++++
++++++++++++++++++++
++++++++++     +++++
++++++++++     +++++
++++++++++a +  +++++
++++++++++  +   A ++
++++++++++  ++    ++
++++++++++  ++++++++
++++++++++  ++++++++
++++++++++  ++++++++
++++++  0  +++++++++
+++++++    +++++++++
++++++++++++++++++++
++++++++++++++++++++
++++++++++++++++++++
++++++++++++++++++++
++++++++++++++++++++
++++++++++++++++++++
++++++++++++++++++++
++++++++++++++++++++
