++++++++++++++++++++
++++++++++++++++++++
++++++++++++++++++++
++++++++++++++++++++
++++++++++++++++++++
++++++++++++++++++++
++++++++++++++++++++
++++++++++++++++++++
++++++++++++++++++++
++++++++++++++++++++
+++++++++++a +++++++
+++++++++++  +++++++
+++++++++++ A0++++++
+++++++++++    +++++
+++++++++++    ++  +
+++++++++++    ++  +
+++++++++++    ++  +
+++++++++++++      +
++++++++++++++    ++
++++++++++++++++++++
