++++++++++++++++++++
++++++++++++++++++++
++++++     +++++++++
++++++      ++++++++
++++++  A  +++++++++
++++++    ++++++++++
++++++    ++++++++++
++++++    ++++++++++
++++  a 0 ++++++++++
++++    ++++++++++++
+++++   ++++++++++++
+++++   ++++++++++++
+++++  +++++++++++++
++++++ +++++++++++++
++++++++++++++++++++
++++++++++++++++++++
++++++++++++++++++++
++++++++++++++++++++
++++++++++++++++++++
++++++++++++++++++++
