++++++++++++++++++++
++++++++++++++++++++
++++++++++++++++++++
++++++++++++++++++++
++++++++++++++++++++
++++++++++++++++++++
++++ A++++++++++++++
++++  ++++++++++++++
++++  ++++++++++++++
++++  ++++++++++++++
++    ++++++++++++++
++    ++++++++++++++
++++  ++++++++++++++
++++  ++++++++++++++
++++  a   0  +++++++
+++++         ++++++
++++++++++++   ++  +
+++++++++++++      +
+++++++++++++++   ++
++++++++++++++++++++
