++++++++++++++++++++
++++++++++++++++++++
++++++++++++++++++++
++++++++++++++++++++
++++++++++++++++++++
++++++++++++++++++++
++++++++++++++++++++
++++++++++++++++++++
++++++++++++++++++++
++++++++++++++++++++
++++++++++++++++++++
++++++++++++++++++++
++++++++++++++  ++++
++++++++++++++ A++++
++++++++++++++  ++++
++++++++++++++a ++++
+++++0    ++++   +++
++++++            ++
++++++++++     +  ++
++++++++++++++++++++
