++++++++++++++++++++
++++++++++++++++++++
++++++++++++++++++++
++++++++++++++++++++
++++++++++++++++++++
++++++++++++++++++++
++++++++++++++++++++
+++++++++++++++++  +
++++++++++++++  +  +
++++++++++++++  +  +
++++++++++++++ A+  +
+++++++++++++   +  +
++++++++++++++  +  +
++++++++++++++ a+  +
+++++++++++++++    +
+++++++++++++++    +
+++++++++++++++0   +
+++++++++++++++    +
++++++++++++++++++++
++++++++++++++++++++
