++++++++++++++++++++
++++++++++++++++++++
++++++++++    A    +
++++++++++ a       +
+++++       +++++  +
++++++      +++++  +
++++++++++0 +++++  +
++++++++++++++++++++
++++++++++++++++++++
++++++++++++++++++++
++++++++++++++++++++
++++++++++++++++++++
++++++++++++++++++++
++++++++++++++++++++
++++++++++++++++++++
++++++++++++++++++++
++++++++++++++++++++
++++++++++++++++++++
++++++++++++++++++++
++++++++++++++++++++
