++++++++++++++++++++
++++++++++++++++++++
+++++++++++++++ 0  +
+++++++++++++++    +
++++++++++++++ A   +
+++++++++++++++a   +
+++++++++++++++    +
+++++++++++++++    +
+++++++++++++++++  +
+++++++++++++++++  +
+++++++++++++++++  +
+++++++++++++++++  +
+++++++++++++++++  +
+++++++++++++++++  +
+++++++++++++++++  +
++++++++++++++++++++
++++++++++++++++++++
++++++++++++++++++++
++++++++++++++++++++
++++++++++++++++++++
