++++++++++++++++++++
++++++++++++++++++++
++++  ++++++++++++++
++++  ++  ++++++++++
+++      0++++++++++
+++        +++++++++
++  +++++ a+++++++++
++  +++++  +++++++++
++  +++++  +++++++++
++ ++++++  +++++++++
+++++++++  +++++++++
+++++++++      +++++
++++++++++    A+++++
++++++++++++++++++++
++++++++++++++++++++
++++++++++++++++++++
++++++++++++++++++++
++++++++++++++++++++
++++++++++++++++++++
++++++++++++++++++++
