++++++++++++++++++++
++++++++++++++++++++
++++++++++++  ++++++
++++++++++++  ++++++
++++++++++++  ++++++
++++++++  ++  ++++++
++++++++  ++  ++++++
++++++++  ++  ++++++
++++++++   0 +++++++
+++++   A  a +++++++
++++++    ++++++++++
+++++++++ ++++++++++
++++++++++++++++++++
++++++++++++++++++++
++++++++++++++++++++
++++++++++++++++++++
++++++++++++++++++++
++++++++++++++++++++
++++++++++++++++++++
++++++++++++++++++++
