++++++++++++++++++++
++++++++++++++++++++
++++++  ++++++++++++
++++++  ++++++++++++
++++++  ++++++++++++
++++++  ++++++++++++
++++++0     +++   ++
++++++  A     a   ++
++++++++++++    ++++
++++++++++++++++++++
++++++++++++++++++++
++++++++++++++++++++
++++++++++++++++++++
++++++++++++++++++++
++++++++++++++++++++
++++++++++++++++++++
++++++++++++++++++++
++++++++++++++++++++
++++++++++++++++++++
++++++++++++++++++++
