++++++++++++++++++++
++++++++++++++++++++
++++++++++++++++++++
+++++     ++++++++++
+++++      +++++++++
+++++  ++  +++++++++
+++++ 0++A +++++++++
+++++ +++a +++++++++
+++++++++  +++++++++
+++++++++  +++++++++
+++++++++  +++++++++
+++++++++  ++++   ++
++++++++++        ++
+++++++++++      +++
++++++++++++++++++++
++++++++++++++++++++
++++++++++++++++++++
++++++++++++++++++++
++++++++++++++++++++
++++++++++++++++++++
