++++++++++++++++++++
++++++++++++++++++++
+++++++++++++   ++++
++++++++++ A    ++++
++++++++++        ++
+++++++  +a ++    ++
+++++++    +++   +++
+++++++  0 ++++  +++
+++++++  +++++++++++
+++++++  +++++++++++
++++ ++  +++++++++++
++++    ++++++++++++
+++++   ++++++++++++
++++++++++++++++++++
++++++++++++++++++++
++++++++++++++++++++
++++++++++++++++++++
++++++++++++++++++++
++++++++++++++++++++
++++++++++++++++++++
