++++++++++++++++++++
++++++++++++++++++++
++++++++++++++++++++
++++++++++++++++++++
++++++++++++++++++++
++++++++++++++++++++
+++++++++0 +++++++++
+++++++++  ++++++  +
+++++++++  ++++++  +
+++++++++   +++++  +
+++++++++   +++++  +
+++++++++   +++++  +
++++++++++  +++++  +
++++++++++  A      +
+++++++++++     a  +
+++++++++++++++++  +
++++++++++++++++++++
++++++++++++++++++++
++++++++++++++++++++
++++++++++++++++++++
