++++++++++++++++++++
++++++++++++++++++++
++++++++++++++++++++
++++++++++++++++++++
++++++++++++++++++++
++++++++++++++++++++
++++++++++++++++++++
++++++++++++++++++++
++++++++++++++++++++
+++++++++++++++++  +
+++++++++++++      +
+++++++++++++A     +
+++++++++++    ++  +
+++++++++++ a  ++  +
+++++++++++  ++++  +
+++++++++++0 ++++  +
++++++++++  +++++  +
+++++++++++ +++++  +
++++++++++++++++++++
++++++++++++++++++++
