++++++++++++++++++++
++++++++++++++++++++
++++++++++++  ++++++
++++++++++++0 ++++++
++++++++++++  ++++++
+++++++ ++++  ++++++
+++++++  + A  ++++++
+++++++      a++++++
++++++++      ++++++
+++++++++++  +++++++
++++++++++++++++++++
++++++++++++++++++++
++++++++++++++++++++
++++++++++++++++++++
++++++++++++++++++++
++++++++++++++++++++
++++++++++++++++++++
++++++++++++++++++++
++++++++++++++++++++
++++++++++++++++++++
