++++++++++++++++++++
++++++++++++++++++++
+++++++++++++++++  +
++++++++++++++  +  +
++++++++++++++  0 ++
++++++++++++++    ++
++++++++++++++  ++++
++++++++++++++ A++++
+++++++++++++ a+++++
++++++++++++++ +++++
++++++++++++++++++++
++++++++++++++++++++
++++++++++++++++++++
++++++++++++++++++++
++++++++++++++++++++
++++++++++++++++++++
++++++++++++++++++++
++++++++++++++++++++
++++++++++++++++++++
++++++++++++++++++++
