++++++++++++++++++++
++++++++++++++++++++
++         +++++++++
+++      0 +++++++++
+++++++++  +++++++++
+++++++++  +++++++++
+++++++++  +++++++++
+++++++++  +++++++++
+++++++++  +++++++++
+++++++++  +++++++++
+++++++++  +++++++++
+++++++++ a+++++++++
+++++++++  +++++++++
+++++++++       ++++
++++++++++A     ++++
++++++++++++++++++++
++++++++++++++++++++
++++++++++++++++++++
++++++++++++++++++++
++++++++++++++++++++
