++++++++++++++++++++
++++++++++++++++++++
++++++++++++++++++++
++++++++++++++++++++
+++++++++    +++++++
+++++++++     ++++++
+++++++++ A+  ++++++
+++++++++  +  ++++++
+++++++++a +  ++++++
+++++++++  +  ++++++
+++++++++  +  ++++++
++++++++++++ 0 +++++
+++++++++++++   ++++
++++++++++++++  ++++
++++++++++++++  ++++
++++++++++++++  ++++
++++++++++++++  ++++
++++++++++++++  ++++
++++++++++++++++++++
++++++++++++++++++++
