++++++++++++++++++++
++++++++++++++++++++
++++++++++++++++++++
++++++++++++++++++++
++++++++++++++++++++
++++++++++++++++++++
++++++++++++++++++++
++++++++++++++++++++
++++++++++++++++++++
++++++++++++++++++++
+++++++++  0   A +++
+++++++++  a      ++
++++++++++++++++  ++
++++++++++++++++  ++
++++++++++++++++  ++
++++++++++++++++   +
++++++++++++++++   +
+++++++++++++++++  +
+++++++++++++++++ ++
++++++++++++++++++++
