++++++++++++++++++++
++++++++++++++++++++
++++++++++++++++++++
++++++++++++++++++++
+++++++++++  +++++++
+++++++++++A +++++++
+++++++++++  ++++  +
+++++++++++  ++++  +
+++++++++++  +++   +
+++++++++++  a     +
++++++++++++ 0    ++
++++++++++++++++++++
++++++++++++++++++++
++++++++++++++++++++
++++++++++++++++++++
++++++++++++++++++++
++++++++++++++++++++
++++++++++++++++++++
++++++++++++++++++++
++++++++++++++++++++
