++++++++++++++++++++
++++++++++++++++++++
+++0      +++++++  +
++++A      +       +
+++++++++  +       +
+++++++++  +  ++++++
+++++++++   a ++++++
++++++++++    ++++++
++++++++++++++++++++
++++++++++++++++++++
++++++++++++++++++++
++++++++++++++++++++
++++++++++++++++++++
++++++++++++++++++++
++++++++++++++++++++
++++++++++++++++++++
++++++++++++++++++++
++++++++++++++++++++
++++++++++++++++++++
++++++++++++++++++++
