++++++++++++++++++++
++++++++++++++++++++
+++++      +++++++++
++++++     +++++++++
++++++++A  +++++++++
++++++++   +++++++++
+++++++++a +++++++++
+++++++++  +++++++++
+++++++++  +++++++++
+++++++++ 0+++++++++
+++++++++  +++++++++
++++++++++++++++++++
++++++++++++++++++++
++++++++++++++++++++
++++++++++++++++++++
++++++++++++++++++++
++++++++++++++++++++
++++++++++++++++++++
++++++++++++++++++++
++++++++++++++++++++
