++++++++++++++++++++
++++++++++++++++++++
++++++++++++++++++++
++++++++++++++++++++
++++++++++++++++++++
++++++++++++++++++++
++++++++++++++++++++
++++++++++ +++++++++
++++++++++  ++++++++
++++++++++  ++++++++
++++++++++  ++++++++
++++++++++  ++++++++
++++++++++  ++++++++
++++++++++0 +++++  +
+++++++++++  ++++  +
+++++++++++  ++++  +
+++++++++++A ++ a  +
+++++++++++        +
++++++++++++    + ++
++++++++++++++++++++
