++++++++++++++++++++
++++++++++++++++++++
++++++++++++++++++++
++++++  ++++++++++++
++++++  ++++++++++++
++++++  ++++++++++++
++++++      ++++++++
+++++++  A   +++++++
+++++++   +  +++++++
+++++++  ++ a+++++++
++++++++ ++  +++++++
+++++++++++0 +++++++
+++++++++++  +++++++
+++++++++++  +++++++
+++++++++++  +++++++
+++++++++++  +++++++
+++++++++++  +++++++
++++++++++++  ++++++
++++++++++++++++++++
++++++++++++++++++++
