++++++++++++++++++++
++++++++++++++++++++
++++++++++++++++++++
++++++++++++++++++++
++++++++++++++++++++
++++++++++++++++++++
++++++++++++++++++++
++++++++++++  ++++++
++++++++++++    ++++
++++++++++++     +++
++++++++++++  +  +++
++++++++++++  + 0+++
++++++++++++a +  +++
++++++++++++A +  +++
+++++++++++++++    +
+++++++++++++++    +
++++++++++++++++   +
+++++++++++++++++  +
++++++++++++++++++++
++++++++++++++++++++
