++++++++++++++++++++
++++++++++++++++++++
++++++++++++++++++++
++++++++++++++++++++
++++++++++++++++++++
++++++++++++++++++++
++++++++++++++++++++
++++++++++++++++++++
++++++++++++++++  ++
++++++++++++++++   +
++++++++++  a ++   +
+++++++++++   ++   +
++++++++++++  ++   +
++++++++++++   A   +
++++++++++++0      +
++++++++++++  ++++++
++++++++++++++++++++
++++++++++++++++++++
++++++++++++++++++++
++++++++++++++++++++
