++++++++++++++++++++
++++++++++++++++++++
++++++++++++++++++++
++++++++++++++++++++
++++++++++++++++++++
++++++ +++++++++++++
++++++  ++++++++++++
++++++  ++++++++++++
++++++  ++++++++++++
++++++  ++++  ++++++
++++++  ++++  ++++++
++++++ A++++a ++++++
++++++  ++++  ++++++
++++++   0    ++++++
+++++++       ++++++
++++++++++++++++++++
++++++++++++++++++++
++++++++++++++++++++
++++++++++++++++++++
++++++++++++++++++++
