++++++++++++++++++++
++++++++++++++++++++
++++++++++++++++++++
++++++++++++++++++++
++++++++++++++++++++
++++++++++++++++++++
++++++++++++++++++++
++++++++++++++++++++
++++++++++++++++++++
++++++++++++++++++++
++++++++++++++++++++
+++++++0++++++++++++
+++++++   A ++++++++
+++++++      +++++++
+++++++  ++  +++++++
+++++++  ++  +++  ++
+++++++ a++  +++  ++
+++++++++++       ++
++++++++++++     +++
++++++++++++++++++++
