++++++++++++++++++++
++++++++++++++++++++
+++++++++++++++++  +
++++++++++++++ ++  +
++++++++++++++  +  +
++++++++++++++  +  +
++++++++++++++ 0   +
++++++++++++++  a  +
++++++++++++++ A+ ++
++++++++++++++++++++
++++++++++++++++++++
++++++++++++++++++++
++++++++++++++++++++
++++++++++++++++++++
++++++++++++++++++++
++++++++++++++++++++
++++++++++++++++++++
++++++++++++++++++++
++++++++++++++++++++
++++++++++++++++++++
