++++++++++++++++++++
++++++++++++++++++++
++++++++++++++++++++
++++++++++++++++++++
++++++++++++++    ++
++++++++++++++     +
++++++++++++++  +  +
++++++++++++++  +  +
++++++++++++++  +  +
++++++++++ +++  +  +
++++++++++  ++  +  +
++++++++++  ++  +  +
++++++++++  ++  +  +
++++++++++  ++  ++++
++++++++++ 0++  ++++
+++++++++++   a+++++
++++++++++++A  +++++
++++++++++++++++++++
++++++++++++++++++++
++++++++++++++++++++
