++++++++++++++++++++
++++++++++++++++++++
++++++++++ +++++++++
++++++++++    0+++++
+++++++++++     ++++
++++++++++++++  ++++
++++++++++++++ A++++
++++++++++++++  ++++
++++++++++++++a ++++
++++++++++++++  ++++
++++++++++++++    ++
+++++++++++++++    +
+++++++++++++++++  +
+++++++++++++++++  +
+++++++++++++++++  +
+++++++++++++++++  +
+++++++++++++++++  +
+++++++++++++++++  +
++++++++++++++++++++
++++++++++++++++++++
