++++++++++++++++++++
++++++++++++++++++++
+++++++ a ++++++++++
+++++++     A 0+++++
+++++++++         ++
+++++++++    +     +
++++++++++  ++     +
+++++++++++ +++    +
++++++++++++++++++++
++++++++++++++++++++
++++++++++++++++++++
++++++++++++++++++++
++++++++++++++++++++
++++++++++++++++++++
++++++++++++++++++++
++++++++++++++++++++
++++++++++++++++++++
++++++++++++++++++++
++++++++++++++++++++
++++++++++++++++++++
