++++++++++++++++++++
++++++++++++++++++++
++++++++++++++++++++
++++++++++++++++++++
++++++++++++++++++++
++++++++++++++++++++
++++++++++++++++++++
++++++++++++++++++++
++++++++++++++++++++
+++++++++++      +++
+++++++++++0a     ++
+++++++++++  +++  ++
+++++++++++  +++  ++
+++++++++++  +++  ++
+++++++++++  +++  ++
++++++++++++++++A ++
++++++++++++++++++++
++++++++++++++++++++
++++++++++++++++++++
++++++++++++++++++++
