++++++++++++++++++++
++++++++++++++++++++
++++++++++++++++++++
++++++++++++++++++++
++++++++++++++++++++
++++++++++++++++++++
+++++++++++++++++  +
+++++++++++++++++  +
+++++++++++++++++  +
+++++++++++++++++  +
++++++++++++++++   +
++++++++++++++++   +
++++++++++++++++0  +
+++++++++    +++   +
++++++++++ A  ++  ++
++++++++++++  ++  ++
++++++++++++    a+++
+++++++++++++    +++
++++++++++++++++++++
++++++++++++++++++++
