++++++++++++++++++++
++++++++++++++++++++
++++++++++++++++++++
++++++++++++++++++++
++++++++++++++++++++
+++++++++++++++++  +
++++++++++++++++0  +
++++++++++++++++   +
++++++++++++++++   +
++++++++++++++++a  +
++++++++++++++++   +
++++++++++++++++   +
++++++++++++++++  ++
++++++++++++++++  ++
++++++++++++++++  ++
++++++++++++++++A+++
++++++++++++++++++++
++++++++++++++++++++
++++++++++++++++++++
++++++++++++++++++++
