++++++++++++++++++++
++++++++++++++++++++
++++       +++++++++
+++++      +++++++++
+++++++++A +++++++++
+++++++++a +++++++++
+++++++++  +++++++++
+++++++++  +++++++++
+++++++++  +++++++++
+++++++++  +++++++++
+++++++++  +++++++++
+++++++++  +  ++++++
+++++++++  +  ++++++
+++++++++  +  ++++++
+++++++++     ++++++
++++++++++  0 ++++++
++++++++++++++++++++
++++++++++++++++++++
++++++++++++++++++++
++++++++++++++++++++
