++++++++++++++++++++
++++++++++++++++++++
++++++++  ++++++++++
++++++++  ++++++++++
++++++++ a++++++++++
++++++++  ++++++++++
++++++++0A++++++++++
++++++++  ++++++++++
++++++++   +++++  ++
++++++++    ++++   +
+++++++++    +++  ++
+++++++++++       ++
++++++++++++     +++
++++++++++++++++++++
++++++++++++++++++++
++++++++++++++++++++
++++++++++++++++++++
++++++++++++++++++++
++++++++++++++++++++
++++++++++++++++++++
