++++++++++++++++++++
++++++++++++++++++++
+++++++++  +++++++++
++++++++0   ++++++++
++++++++    ++++++++
++++++++    ++++++++
++++++++ +    ++++++
++++++++++     +++++
++++++++++  +  +++++
+++++++++++++a +++++
+++++++++++++  +++++
++++++++++++++  ++++
++++++++++++++  ++++
++++++++++++++  ++++
++++++++++++++A ++++
++++++++++++++  ++++
++++++++++++++  ++++
++++++++++++++  ++++
++++++++++++++++++++
++++++++++++++++++++
