++++++++++++++++++++
++++++++++++++++++++
++++++++++++++++++++
++++++++++++++++++++
++++++++++++++++++++
++++++++++++++++++++
++++++++++++++++++++
++++++++++++++++++++
++++++++++++++++++++
++++++++++++++++++++
++++++++++++++++++++
++++++++++++++++++++
++++++++++++++++++++
++++++++++++++ A+  +
++++++++++++++a +  +
+++++++++++++++    +
+++++++++++++++0   +
+++++++++++++++    +
++++++++++++++++ +++
++++++++++++++++++++
