++++++++++++++++++++
++++++++++++++++++++
++++++++++++++++++++
++++++++++++++++++++
++++++++++++++++++++
++++++++++++++++++++
++++++++++++++++++++
++++++++++++++++++++
++++++++++++++++++++
++++++++++++++++++++
++++++++++++++++++++
++++++++++++++++++++
++++++++++++ a++++++
++++++++++++A ++++++
++++++  + 0   ++++++
++++++  +     +++  +
++++++    ++  +++  +
+++++++   ++       +
+++++++++++++     ++
++++++++++++++++++++
