++++++++++++++++++++
++++++++++++++++++++
++++++++++++++++++++
++++++++++++++++++++
++++++++++++++++++++
++++++++++++++++++++
++++++++++++++++++++
++++++++++++++++++++
++++++++++++++++++++
+++++++++++  +++++++
+++++++++++A +++++++
+++++++++++  +++++++
+++++++++++  +++++++
+++++++++++  +++++++
+++++++    a +++++++
++++++++    0+++++++
+++++++++++  +++++++
+++++++++++  +++++++
++++++++++++++++++++
++++++++++++++++++++
