++++++++++++++++++++
++++++++++++++++++++
++++++++++++++++++++
++++++++++++++++++++
++++++++++++++++++++
++++++++++++++++++++
++++++++++++++++++++
++++++++++++++++++++
++++++++++  0 ++++++
++++++++++     +++++
+++++++++  ++  +++++
++++++++++ ++  +++++
+++++++++++++    +++
+++++++++++++ A   ++
+++++++++++++a +  ++
+++++++++++++  +  ++
++++++++++++++++  ++
++++++++++++++++  ++
++++++++++++++++++++
++++++++++++++++++++
