++++++++++++++++++++
++++++++++++++++++++
++++++++++++++++++++
++++++++++++++++++++
++++++++++++++++++++
++++++++++++++++++++
++++++++++++++++++++
++++++++++++++++++++
++++++++++++++++++++
+++++++++++++  +++++
+++++++++++++ a+++++
++++++          ++++
+++++++ A       ++++
+++++++++++++   ++++
+++++++++++++  +++++
+++++++++++++  +++++
+++++++++++++0 +++++
+++++++++++++  +++++
++++++++++++++++++++
++++++++++++++++++++
