++++++++++++++++++++
++++++++++++++++++++
++++++++++++++++++++
++++++  ++++++++++++
++++++  ++++++++++++
++++++  0    +++++++
++++++      A ++++++
++++++  ++++  ++++++
++++++ +++++   +++++
+++++++++++++   +  +
++++++++++++++     +
+++++++++++++++a   +
+++++++++++++++++  +
+++++++++++++++++  +
++++++++++++++++++++
++++++++++++++++++++
++++++++++++++++++++
++++++++++++++++++++
++++++++++++++++++++
++++++++++++++++++++
