++++++++++++++++++++
++++++++++++++++++++
++++++++++++++++++++
++++++++++++++++++++
++++++++++++++++++++
++++++++++++++++++++
++++++++++++++++++++
++++++++++++++++++++
++++++++++++++++++++
++++++++++++++++++++
++++++++++++++++++++
+++++++++++++  +++++
+++++++++++++  +++++
+++++++++++++a +++++
+++++++++++++  +++++
+++++++++A    0++  +
++++++++++     ++  +
+++++++++++ +      +
++++++++++++++    ++
++++++++++++++++++++
