++++++++++++++++++++
++++++++++++++++++++
++++++++++++++++++++
+++++  ++ a+++++++++
+++++A ++0    ++++++
+++++          +++++
++++++     ++  +++++
+++++++++  ++  +++++
+++++++++++++  +++++
+++++++++++++  +++++
+++++++++++++  +++++
+++++++++++++  +++++
+++++++++++++  +++++
++++++++++++++++++++
++++++++++++++++++++
++++++++++++++++++++
++++++++++++++++++++
++++++++++++++++++++
++++++++++++++++++++
++++++++++++++++++++
