++++++++++++++++++++
++++++++++++++++++++
+++++++++++++++ ++++
+++++++++++++++  +++
+++++++++++++++ a+++
+++++++++++++++0A+++
+++++++++++++++    +
+++++++++++++++    +
++++++++++++++++   +
+++++++++++++++++  +
+++++++++++++++++  +
+++++++++++++++++  +
+++++++++++++++++  +
+++++++++++++++++  +
+++++++++++++++++  +
+++++++++++++++++  +
+++++++++++++++++  +
+++++++++++++++++  +
++++++++++++++++++++
++++++++++++++++++++
