++++++++++++++++++++
++++++++++++++++++++
+++++++++++++++++  +
+++++++++++++++    +
+++++++++++++++    +
++++++++++++++  +  +
++++++++++++++ a+ ++
++++++++++++++  ++++
++++++++++++++  ++++
++++++++++++++  ++++
++++++++++++++  ++++
+++++++++++  +  ++++
+++++++++++    +++++
+++++++++++ A  +++++
+++++++++++  +++++++
+++++++++++ 0+++++++
+++++++++++ ++++++++
++++++++++++++++++++
++++++++++++++++++++
++++++++++++++++++++
