++++++++++++++++++++
++++++++++++++++++++
++++++++++++   ++  +
++++++++++++       +
++++++++++++       +
++++++++++++  +++  +
++++++++++++  +++  +
++++++++++++  +++  +
+++          +++++++
+++ a A 0    +++++++
++++++++++++++++++++
++++++++++++++++++++
++++++++++++++++++++
++++++++++++++++++++
++++++++++++++++++++
++++++++++++++++++++
++++++++++++++++++++
++++++++++++++++++++
++++++++++++++++++++
++++++++++++++++++++
