++++++++++++++++++++
++++++++++++++++++++
++++++++++++++++++++
+++++++++++++++ ++++
+++++++++++++++A +++
+++++++++++++++  +++
+++++++++++++++    +
+++++++++++++++ a  +
++++++++++++++++0  +
+++++++++++++++++  +
+++++++++++++++++  +
+++++++++++++++++  +
+++++++++++++++++  +
+++++++++++++++++  +
+++++++++++++++++  +
++++++++++++++++++++
++++++++++++++++++++
++++++++++++++++++++
++++++++++++++++++++
++++++++++++++++++++
