++++++++++++++++++++
++++++++++++++++++++
++++++++++++++++++++
++++++++++++++++++++
++++++++++++++++++++
++++++++++++++++++++
++++++++++++++++++++
++++++++++++++++++++
++++++++++++++++++++
++++++++++++++++++++
++++++++++++++++++++
++++++++++++++++++++
++++++++++++++++++++
++++++++  ++++++++++
++++++++ a++++++++++
++++++    ++++++++++
+++++   A0++++++++++
+++++    +++++++++++
++++++   +++++++++++
++++++++++++++++++++
