++++++++++++++++++++
++++++++++++++++++++
++++++++++++++++++++
++++++++++++++++++++
++++++++++++++++++++
++++++++++++++++++++
++++++++++++++++++++
++++++++++++++++++++
++++++++++++++++++++
++++++++++++++++++++
+++++++++++  +++++++
+++++++++++ a+++++++
++ ++++++++  +++++++
++   ++++++A +++++++
+++   +++++  +++++++
++++            ++++
++++      0     ++++
++++  +++++  +++++++
++++++++++++++++++++
++++++++++++++++++++
