++++++++++++++++++++
++++++++++++++++++++
++++++++++ +++++++++
++++++++++  ++++++++
++++++++++  +++++  +
++++++++++  +++++  +
++++++++++  +++++  +
++++++++++  +   A  +
++++++++++  + a 0  +
++++++++++    +++  +
++++++++++    +++  +
+++++++++++ +++++  +
+++++++++++++++++  +
++++++++++++++++++++
++++++++++++++++++++
++++++++++++++++++++
++++++++++++++++++++
++++++++++++++++++++
++++++++++++++++++++
++++++++++++++++++++
