++++++++++++++++++++
++++++++++++++++++++
++++++++++++++++++++
++++++++++++++++++++
++++++++++++++++++++
++++++++++++++++++++
++++++++++++++++++++
++++++++++++++++++++
++++++++++++++++++++
++++++++++++++++++++
++++++++++++++++++++
++++++++++++++++++++
++++++++++++++  +  +
++++++++++  ++  +  +
++++++++++  ++  +  +
++++++++++      a  +
++++++++++   A  0  +
+++++++++++++++++  +
++++++++++++++++++++
++++++++++++++++++++
