++++++++++++++++++++
++++++++++++++++++++
+++++++++++    A++++
+++++++++++     ++++
++++++++++++++  ++++
++++++++++++++a ++++
++++++++++++++  0 ++
+++++++++++++++    +
++++++++++++++++++++
++++++++++++++++++++
++++++++++++++++++++
++++++++++++++++++++
++++++++++++++++++++
++++++++++++++++++++
++++++++++++++++++++
++++++++++++++++++++
++++++++++++++++++++
++++++++++++++++++++
++++++++++++++++++++
++++++++++++++++++++
