++++++++++++++++++++
++++++++++++++++++++
++++++  ++  ++++++++
++++++a ++  ++++++++
+++++++  +  ++++++++
+++++++  +  ++++++++
+++++++    +++++++++
+++++++    +++++++++
+++++++    +++++++++
+++++++A   +++++++++
++++++++  ++++++++++
+++++++++0++++++++++
++++++++++++++++++++
++++++++++++++++++++
++++++++++++++++++++
++++++++++++++++++++
++++++++++++++++++++
++++++++++++++++++++
++++++++++++++++++++
++++++++++++++++++++
