++++++++++++++++++++
++++++++++++++++++++
++++++++++++++++++++
++++++++++++++a ++++
++++++++++++++   +++
++++++++++++++A  +++
+++++++++++++++ 0+++
+++++++++++++++   ++
+++++++++++++++    +
+++++++++++++++++  +
+++++++++++++++++  +
+++++++++++++++++  +
+++++++++++++++++  +
+++++++++++++++++  +
+++++++++++++++++  +
+++++++++++++++++  +
+++++++++++++++++ ++
++++++++++++++++++++
++++++++++++++++++++
++++++++++++++++++++
