++++++++++++++++++++
++++++++++++++++++++
++     ++++   ++++++
++      +++    +++++
++  ++   ++ 0  +++++
++  +++   +    +++++
++ +++++  +A a +++++
++++++++    ++++++++
+++++++++   ++++++++
++++++++++++++++++++
++++++++++++++++++++
++++++++++++++++++++
++++++++++++++++++++
++++++++++++++++++++
++++++++++++++++++++
++++++++++++++++++++
++++++++++++++++++++
++++++++++++++++++++
++++++++++++++++++++
++++++++++++++++++++
