++++++++++++++++++++
++++++++++++++++++++
++++++++++++++++++++
++++++++++++++++++++
++++++++++++++++++++
+++++++++++++++    +
+++++++++++++0+    +
+++++++++++++a A+  +
++++++++++++++  +  +
+++++++++++++++++  +
+++++++++++++++++  +
++++++++++++++++++++
++++++++++++++++++++
++++++++++++++++++++
++++++++++++++++++++
++++++++++++++++++++
++++++++++++++++++++
++++++++++++++++++++
++++++++++++++++++++
++++++++++++++++++++
