++++++++++++++++++++
++++++++++++++++++++
++++++++++++++++++++
++++++++++++++++++++
++++++++++++++++++++
++++++++++++++++++++
+++ ++++   +++++++++
+++  +++   a++++++++
+++  +++    ++++++++
+++  +++    ++++++++
+++      +  ++++++++
+++      +  ++++++++
+++A   +++   +++++++
+++    +++   +++++++
+++  0+++++  +++++++
++++  ++++++++++++++
++++++++++++++++++++
++++++++++++++++++++
++++++++++++++++++++
++++++++++++++++++++
