++++++++++++++++++++
++++++++++++++++++++
++++++++++++++++++++
++++++++++++++++++++
++++++++++++++++++++
++++++++++++++++++++
++++++++++++++++++++
++++++++++++++++++++
++++++++++++++++++++
++++++++++++++++++++
++ +++++++++++++++++
++A ++++++++++++++++
++  ++++++++++++++++
++ a++++++++++++++++
++  ++++  ++++++++++
++  ++++  ++++++++++
++0   ++  ++++++++++
+++         ++++++++
++++++      ++++++++
++++++++++++++++++++
