++++++++++++++++++++
++++++++++++++++++++
++++++++++++++++++++
++++++++++++++++++++
++++++++++++++++++++
++++++++++++++++++++
++++++++++++++++++++
++++++++++++++++++++
++++++++++++++++++++
+++++++++    +++++++
+++++++++    +++++++
++A +++++  +++++++++
++a0+++++  +++++++++
++  +++++  +++++++++
++  +++++  +++++++++
++  +++    +++++++++
++  +++    +++++++++
+++        +++++++++
++++    ++++++++++++
++++++++++++++++++++
