++++++++++++++++++++
++++++++++++++++++++
++++++++++++++++++++
++++++++++++++++++++
++++++++++++++++++++
++++++++++++++++++++
++++++++++++++++++++
++++++++++++++++++++
++++++++++++++++++++
++++++++++++++++++++
++++++++++++++++++++
++++++++++++++++++++
++++++++  ++++++++++
++++++++  ++++++++++
++++++++  0  +++++++
+++++++++  A  +++  +
++++++++++++ a     +
++++++++++++       +
+++++++++++++++++ ++
++++++++++++++++++++
