++++++++++++++++++++
++++++++++++++++++++
++++++++++++++++++++
++++++++++++++++++++
+++++++++++++  +++++
+++++++++++++  +++++
+++++++++++++0 +++++
+++++++++++++  +++++
++++++++++    ++++++
++++++++++    ++++++
++++++++++  ++++++++
++++++++++  ++++++++
++++++++++ A++++++++
++++++++++  ++++++++
+++ ++++   +++++++++
+++  +++   +++++++++
+++     a ++++++++++
+++       ++++++++++
++++  ++++++++++++++
++++++++++++++++++++
