++++++++++++++++++++
++++++++++++++++++++
+++++++          +++
+++++++   0  a    ++
++++++  +++++++    +
+++++++ +++++++ A  +
+++++++++++++++    +
+++++++++++++++    +
+++++++++++++++++  +
+++++++++++++++++  +
++++++++++++++++++++
++++++++++++++++++++
++++++++++++++++++++
++++++++++++++++++++
++++++++++++++++++++
++++++++++++++++++++
++++++++++++++++++++
++++++++++++++++++++
++++++++++++++++++++
++++++++++++++++++++
