++++++++++++++++++++
++++++++++++++++++++
+++++++++  +++++++++
+++++++++  +++++++++
+++++++++  +++++++++
+++++      +++++++++
++ ++      +++++++++
++  +A ++ a+++++++++
+++    ++ 0+++++++++
++++   ++  +++++++++
+++++++++  +++++++++
+++++++++  +++++++++
+++++++++  +++++++++
++++++++++++++++++++
++++++++++++++++++++
++++++++++++++++++++
++++++++++++++++++++
++++++++++++++++++++
++++++++++++++++++++
++++++++++++++++++++
