++++++++++++++++++++
++++++++++++++++++++
++++++++++++++++  ++
++++++++++++++++  ++
++++++++++++++++  ++
+++++++++++++  +  ++
+++++++++++ +  +  ++
+++++++++++     a ++
+++++++++++       ++
+++++++++++  A0+  ++
++++++++++++   +++++
++++++++++++++++++++
++++++++++++++++++++
++++++++++++++++++++
++++++++++++++++++++
++++++++++++++++++++
++++++++++++++++++++
++++++++++++++++++++
++++++++++++++++++++
++++++++++++++++++++
