++++++++++++++++++++
++++++++++++++++++++
++++++++++++++   +++
++++++++++++++   +++
++++++++++++++   +++
++++++++++++++   +++
++++++++++++++    ++
+++++  +++++++    ++
+++++          +++++
+++++a   A     +++++
+++++  +++++++++++++
+++++0 +++++++++++++
+++++  +++++++++++++
+++++  +++++++++++++
++++++++++++++++++++
++++++++++++++++++++
++++++++++++++++++++
++++++++++++++++++++
++++++++++++++++++++
++++++++++++++++++++
