++++++++++++++++++++
++++++++++++++++++++
++++++++ 0  ++++++++
++++++++     +++++++
++++++++  +A ++  +++
++++++++  +      +++
++++++++  +      +++
++++++++  +  +++++++
++++++++  ++++++++++
++++++++  ++++++++++
++++++++  ++++++++++
++++++++ a++++++++++
++++++++  ++++++++++
++++++++  ++++++++++
++++++++++++++++++++
++++++++++++++++++++
++++++++++++++++++++
++++++++++++++++++++
++++++++++++++++++++
++++++++++++++++++++
