++++++++++++++++++++
++++++++++++++++++++
+++++++++    +0   ++
++++++++  a       ++
++++++++  ++   +  ++
+++++++++ ++   +  ++
++++++++++++A ++++++
++++++++++++  ++++++
++++++++++++  ++++++
++++++++++++++++++++
++++++++++++++++++++
++++++++++++++++++++
++++++++++++++++++++
++++++++++++++++++++
++++++++++++++++++++
++++++++++++++++++++
++++++++++++++++++++
++++++++++++++++++++
++++++++++++++++++++
++++++++++++++++++++
