++++++++++++++++++++
++++++++++++++++++++
+++++++++++++  +++++
+++++++++++++ a++  +
+++++++++++++A ++  +
+++++++++++++  ++  +
+++++++++++++  ++  +
+++++++++++++  ++  +
+++++++++++++0 ++  +
+++++++++++++  ++  +
+++++++++++++      +
++++++++++++++    ++
++++++++++++++++++++
++++++++++++++++++++
++++++++++++++++++++
++++++++++++++++++++
++++++++++++++++++++
++++++++++++++++++++
++++++++++++++++++++
++++++++++++++++++++
