++++++++++++++++++++
++++++++++++++++++++
++++++++++++++++++++
++++++++++++++++++++
++++++++++++++++++++
++++++++++++++++++++
++++++ +++++++++++++
++++++0 ++    ++++++
++++++  ++     +++++
++++++      +  +++++
+++++++     +  +++++
++++++++++ A+  +++++
+++++++++++++a +++++
+++++++++++++  +++++
+++++++++++++  +++++
+++++++++++++  +  ++
+++++++++++++  +  ++
+++++++++++++     ++
++++++++++++++   +++
++++++++++++++++++++
