++++++++++++++++++++
++++++++++++++++++++
++++++++++++++++++++
++++++++++++++++++++
++++++++++++++++++++
++++++++++++++++++++
++++++++++++++++++++
+++++++++++++  +++++
+++++++++++++  +++++
+++++++++++++  +++++
+++++++++++++  +++++
+++++++++++++  +++++
+++++++++++++   ++++
+++++++++++++   ++++
+++++          +++++
++++++a      A +++++
+++++++++++++0 +++++
+++++++++++++  +++++
++++++++++++++++++++
++++++++++++++++++++
