++++++++++++++++++++
++++++++++++++++++++
++++++++++++++++++++
+++++++++++++++++  +
+++++++++++++++++  +
+++++++++++++++++  +
+++++++++++++++++  +
+++++++++++++++++  +
++++++++++++++ a+  +
+++++++++++++++0A  +
+++++++++++++++    +
+++++++++++++++    +
+++++++++++++++    +
+++++++++++++++    +
+++++++++++++++    +
+++++++++++++++   ++
++++++++++++++++  ++
++++++++++++++++++++
++++++++++++++++++++
++++++++++++++++++++
