++++++++++++++++++++
++++++++++++++++++++
++++++++++++++++++++
++++++++++++++++++++
++++++++++++++++++++
++++++++++++++++++++
++++++++++++++++++++
+++++++  A++++++++++
+++++++   a+++++++++
+++++++    +++++++++
+++++++    +++++++++
+++++++    +++++++++
+++++++   0+  ++++++
++      +  +   +++++
+++     +  +   +++++
+++++++++      +++++
++++++++++     +++++
+++++++++++++    +++
++++++++++++++   +++
++++++++++++++++++++
