++++++++++++++++++++
++++++++++++++++++++
+++++++++++++++  +++
++++++++++++++   +++
++++++++++++++0  +++
++++++++++++++  a  +
+++++++++++++++    +
+++++++++++++++ A  +
++++++++++++++++   +
+++++++++++++++++  +
+++++++++++++++++  +
+++++++++++++++++ ++
++++++++++++++++++++
++++++++++++++++++++
++++++++++++++++++++
++++++++++++++++++++
++++++++++++++++++++
++++++++++++++++++++
++++++++++++++++++++
++++++++++++++++++++
