++++++++++++++++++++
++++++++++++++++++++
+++++++  +++++++++++
+++++++  +++++++++++
++++ 0     +++++++++
++++              ++
++++  ++     a  A  +
++++ +++  +++++++  +
+++++++++ +++++++  +
+++++++++++++++++ ++
++++++++++++++++++++
++++++++++++++++++++
++++++++++++++++++++
++++++++++++++++++++
++++++++++++++++++++
++++++++++++++++++++
++++++++++++++++++++
++++++++++++++++++++
++++++++++++++++++++
++++++++++++++++++++
