++++++++++++++++++++
++++++++++++++++++++
++++++++++++++++++++
++++++++++++++++++++
++++++++++++++++++++
++++++++++++++++++++
++++++++++++++++++++
++++++++++++++++++++
++++++++++++++++++++
++++++++++++++++++++
++    ++++++++++++++
+++    0++++++++++++
++++++   +++++++++++
+++++++  ++++++++  +
+++++++  ++++++++  +
+++++++   A       ++
++++++++   a      ++
++++++++++++++++++++
++++++++++++++++++++
++++++++++++++++++++
