++++++++++++++++++++
++++++++++++++++++++
++++++++++++++++++++
+++++++++++++++   ++
+++++++++++  0A    +
++++++++++++a   +  +
+++++++++++++++++  +
+++++++++++++++++  +
+++++++++++++++++  +
+++++++++++++++++  +
+++++++++++++++++  +
+++++++++++++++++  +
+++++++++++++++++  +
+++++++++++++++++  +
+++++++++++++++++  +
+++++++++++++++++  +
+++++++++++++++++  +
+++++++++++++++++  +
+++++++++++++++++ ++
++++++++++++++++++++
