++++++++++++++++++++
++++++++++++++++++++
+++++++++++  +++++++
+++++++++++  +++++++
+++++++++++  +++++++
+++++  ++++  +++++++
+++++   a   ++++++++
+++++       ++++++++
+++++  +++++++++++++
+++++  +++++++++++++
+++++  +++++++++++++
+++++  +++++++++++++
+++++  +++++++++++++
+++    +++++++++++++
++++   +++++++++++++
+++++0A+++++++++++++
+++++  +++++++++++++
+++++  +++++++++++++
++++++++++++++++++++
++++++++++++++++++++
