++++++++++++++++++++
++++++++++++++++++++
+++++++++++  ++++  +
+++++++++++a ++++  +
+++++++++++  A+++  +
++++++++++++   0   +
++++++++++++++     +
+++++++++++++++++  +
++++++++++++++++++++
++++++++++++++++++++
++++++++++++++++++++
++++++++++++++++++++
++++++++++++++++++++
++++++++++++++++++++
++++++++++++++++++++
++++++++++++++++++++
++++++++++++++++++++
++++++++++++++++++++
++++++++++++++++++++
++++++++++++++++++++
