++++++++++++++++++++
++++++++++++++++++++
+++++++++++++++++  +
+++++++++++++++++  +
+++++++++++++++++  +
+++++++++++++++++  +
+++++++++++++++++  +
+++++++++++++++++  +
++++++++++++A     ++
++++++++++++      ++
++++++++++++  ++++++
++++++++++++  ++++++
++++++++++++  ++++++
++++++++++++  ++++++
+++++  a  +0 +++++++
+++++        +++++++
++++++++++   +++++++
++++++++++++++++++++
++++++++++++++++++++
++++++++++++++++++++
