++++++++++++++++++++
++++++++++++++++++++
+++++++++++++++  +++
++++++++         +++
++++++++ a A      ++
+++++++0  ++++++  ++
+++++++   ++++++  ++
+++++++  ++++++++  +
++++++++ ++++++++  +
+++++++++++++++++  +
+++++++++++++++++  +
+++++++++++++++++  +
+++++++++++++++++  +
+++++++++++++++++  +
+++++++++++++++++  +
+++++++++++++++++  +
++++++++++++++++++++
++++++++++++++++++++
++++++++++++++++++++
++++++++++++++++++++
