++++++++++++++++++++
++++++++++++++++++++
++++++++++++++++++++
++++++++++++++++++++
++++++++++++++++++++
++++++++++++++++++++
++++++++++++++++++++
++++++++++++++++++++
++++++++++++++++++++
++++++++++++++++++++
++++++++++++++++++++
+++++++++++++    +++
+++++++++++++      +
+++++++++++++0++   +
++++++++++++++++   +
++++++++++++++++A  +
++++++++++++++++a  +
++++++++++++++++   +
+++++++++++++++++ ++
++++++++++++++++++++
