++++++++++++++++++++
++++++++++++++++++++
++++++++++++++++++++
++++++++++++++++++++
++++++++++++++++++++
++++++++++++++++++++
++++++++++++++++++++
++++++++++++++++++++
++++++++++++++++++++
++++++++++++++++++++
++++++++++++++++++++
++++++++++++++++++++
++++++++++++++++++++
+++++++   ++++++++++
+++++        +++++++
+++++   +    A  a ++
+++ 0 +++         ++
++++  +++    +++++++
++++++++++ + +++++++
++++++++++++++++++++
