++++++++++++++++++++
++++++++++++++++++++
+++++++++++++++++  +
+++++++++++++++++  +
+++++++++++++++++  +
+++++++++++++++++  +
+++++++++++++++++  +
+++++++++++++++++  +
+++++++++++++++++  +
+++++++++++++++++  +
+++++++++++++++++  +
+++++++++++++++++  +
+++++++++++++++++  +
++++++++++++++ ++  +
++++++++++++++  +  +
++++++++++++++  A ++
+++++++++++++++0a ++
++++++++++++++++++++
++++++++++++++++++++
++++++++++++++++++++
