++++++++++++++++++++
++++++++++++++++++++
++++++++++++++++++++
++++++++++++++++++++
++++++++++++++++++++
++++++++++++++++++++
++++++++++++++++++++
++++++++++++++++++++
+++++++++++++  +++++
+++++++++++++  +++++
+++++++++++++  +++++
+++++++++  ++  +++++
+++++++++  ++  +++++
+++++++++  a  ++++++
+++++++++    A++++++
+++++++++0   +++++++
+++++++++  +++++++++
+++++++++  +++++++++
++++++++++++++++++++
++++++++++++++++++++
