++++++++++++++++++++
++++++++++++++++++++
+++++++++++++   ++++
+++++++++++++   ++++
+++++++++++++  +++++
+++++++++++++  +++++
+++++++++++++  +++++
+++++++++++++  +++++
+++++++++++++  +++++
+++++++++++++0 +++++
+++++++++++++  +++++
+++++++++++++  +++++
+++++++++++++  +++++
+++++++++++++  +++++
+++++++++++++  +++++
+++++++++++++aA+++++
+++++++++++++  +++++
++++++++++++++++++++
++++++++++++++++++++
++++++++++++++++++++
