++++++++++++++++++++
++++++++++++++++++++
++++++++++++++++++++
++++++++++++++++++++
++++++++++++++++++++
++++++++++  ++++++++
++++++++++  ++++++++
++++++++++ A++++++++
++++++++++a ++++++++
++++++++++  ++++++++
++++++++++  ++++++++
++++++++++  ++++++++
++++++++++ 0++++++++
++++++++++   +++++++
++++++++++   +++++++
+++++++++++  +++++++
+++++++++++  +++++++
+++++++++++       ++
++++++++++++      ++
++++++++++++++++++++
