++++++++++++++++++++
++++++++++++++++++++
++++++++++++++++++++
++++++++++++++++++++
++++++++++++++++++++
++++++++++++++++++++
++++++++++++++++++++
++++++++++++++++++++
++++++++++++++++++++
++++++++++++++++++++
+++++++++++++++++  +
+++++++++++++++++  +
+++++++++++++++++  +
++++++++++++++++   +
++++++++++++++A    +
+++++++++++++++ a  +
++++++++++++++++0  +
+++++++++++++++++ ++
++++++++++++++++++++
++++++++++++++++++++
