++++++++++++++++++++
++++++++++++++++++++
++++++++++++++++++++
++++++++++++++++++++
++++++++++++++++++++
++++++++++++++++++++
++++++++++++++++++++
++++++++++++++++++++
++++++++++++++++++++
++++++++++++++++++++
++++++++++++  ++++++
++++++++++++a ++++++
++++++++++++  ++++++
++++++++++++  +++  +
++++++++++++  +    +
++++++++++++   A   +
+++++++++++++ 0    +
+++++++++++++++   ++
++++++++++++++++  ++
++++++++++++++++++++
