++++++++++++++++++++
++++++++++++++++++++
++++++++++++++++++++
++++++++++++++++++++
++++++++++++++++++++
++++++++++++++++++++
++++++++++++++++++++
++++++++++++++++++++
++++++++++++++++++++
++++++++++++++++++++
+++++++++++++++++  +
++++++++++++++++A  +
++++++++++++++++a  +
++++++++++++++++   +
++++++++++++++++   +
++++++++++++++++0  +
++++++++++++++++   +
+++++++++++++++++  +
+++++++++++++++++ ++
++++++++++++++++++++
