++++++++++++++++++++
++++++++++++++++++++
++++++++++++++++++++
++++++++++++++++++++
++++++++++++++++++++
++++++++++++++++++++
++++++++++++++++++++
++++++++++++++++++++
++++++++++++++++++++
++++++++++++++++++++
+++++++++++++++++  +
++++++++++++++++   +
++++++++++  +++    +
+++++++++++ 0++    +
+++++++++++  ++ A  +
+++++++++++  a  +  +
++++++++++++    +  +
+++++++++++++++++  +
++++++++++++++++++++
++++++++++++++++++++
