++++++++++++++++++++
++++++++++++++++++++
++++++++++++++++++++
++++++++++++++++++++
++++++++++++++++++++
++++++++++++++++++++
++++++++++++++++++++
++++++++++++++++++++
++++++++++++++++++++
++++++++++++++++++++
+++++++++++++++++  +
+++++++++++++++++  +
++++++++++++++++   +
+++++++++++++++    +
++++++++++++++++a  +
++++++++++++++++A  +
++++++++++++++++0  +
+++++++++++++++++ ++
++++++++++++++++++++
++++++++++++++++++++
