++++++++++++++++++++
++++++++++++++++++++
++++++++++++++++++++
++++++++++++++++++++
++++++++++++++++++++
++++++++++++++++++++
++++++++++++++++++++
++++++++++++++++++++
++++++++++++++++++++
++++++++++++++++++++
++++++++++++++++0 ++
++++++++++++++++   +
++++++++++++++++a  +
++++++++++++++++A  +
++++++++++++++++   +
+++++++++++++++    +
+++++++++++++++    +
++++++++++++++++  ++
++++++++++++++++++++
++++++++++++++++++++
