++++++++++++++++++++
++++++++++++++++++++
++++++++++++++++++++
++++++++++++++++++++
++++++++++++++++++++
++++++++++++++++++++
++++++++++++++++++++
++++++++++++++++++++
++++++++++++++++++++
++++++++++++++++++++
++++++++++++++  ++++
++++++++++++++  a+++
++++++++++++++  A+++
++++++++++++++   +++
+++++++++++++0   +++
+++++++++++++    +++
++++++++++++++   +++
++++++++++++++   +++
++++++++++++++++++++
++++++++++++++++++++
