++++++++++++++++++++
++++++++++++++++++++
++++++++++++++++++++
++++++++++++++++++++
++++++++++++++++++++
++++++++++++++++++++
++++++++++++++++++++
++++++++++++++++++++
++++++++++++++++++++
++++++++++++++++++++
+++++++++++++++    +
+++++++++++++++   ++
+++++++++++++++  +++
+++++++++++++++  +++
+++++++++++++++a +++
+++++++++++++++A +++
++++++++++++ 0  ++++
+++++++++++++   ++++
++++++++++++++++++++
++++++++++++++++++++
