++++++++++++++++++++
++++++++++++++++++++
++++++++++++++++++++
++++++++++++++++++++
++++++++++++++++++++
++++++++++++++++++++
++++++++++++++++++++
++++++++++++++++++++
++++++++++++++++++++
++++++++++++++++++++
++++++++++++++++++++
++++++++++++++++  ++
++++++++++++++++   +
++++++++++++++++   +
++++++++++++++0    +
++++++++++++++ A   +
++++++++++++a  ++  +
+++++++++++++  ++  +
+++++++++++++++++ ++
++++++++++++++++++++
