++++++++++++++++++++
++++++++++++++++++++
++++++++++++++++++++
++++++++++++++++++++
++++++++++++++++++++
++++++++++++++++++++
++++++++++++++++++++
++++++++++++++++++++
++++++++++++++++++++
++++++++++++++++++++
++++++++++++++++++++
++++++++++0 ++++a ++
++++++++++  ++++  ++
++++++++++  +++   ++
++++++++++  +++   ++
++++++++++ A+++  +++
++++++++++    +  +++
++++++++++       +++
+++++++++++ ++  ++++
++++++++++++++++++++
