++++++++++++++++++++
++++++++++++++++++++
++++++++++++++++++++
++++++++++++++++++++
++++++++++++++++++++
++++++++++++++++++++
++++++++++++++++++++
++++++++++++++++++++
++++++++++++++++++++
++++++++++++++++++++
+++++++++++++  +++++
+++++++++++++  +++++
+++++++++++++A +++++
+++++++++++++a +++++
+++++++++++++0 +++++
+++++++++++++  +++++
+++++++++++++  +  ++
+++++++++++++      +
+++++++++++++++  +++
++++++++++++++++++++
