++++++++++++++++++++
++++++++++++++++++++
++++++++++++++++++++
++++++++++++++++++++
++++++++++++++++++++
++++++++++++++++++++
++++++++++++++++++++
++++++++++++++++++++
++++++++++++++++++++
++++++++++++++++++++
++++++++++0 A+++++++
+++++++++++   ++++++
+++++++++++++  +++++
+++++++++++++  +++++
+++++++++++++  ++  +
+++++++++++++a ++  +
+++++++++++++  ++  +
+++++++++++++     ++
++++++++++++++    ++
++++++++++++++++++++
