++++++++++++++++++++
++++++++++++++++++++
++++++++++++++++++++
++++++++++++++++++++
++++++++++++++++++++
++++++++++++++++++++
++++++++++++++++++++
++++++++++++++++++++
++++++++++++++++++++
++++++++++++++++++++
+++++++++++++++++  +
++++++++++++++++   +
++++++++++++++++   +
++++++++++++++++   +
++++++++++++ +++  ++
++++++++++++a ++A ++
++++++++++++0 ++  ++
++++++++++++     +++
+++++++++++++    +++
++++++++++++++++++++
