++++++++++++++++++++
++++++++++++++++++++
++++++++++++++++++++
++++++++++++++++++++
++++++++++++++++++++
++++++++++++++++++++
++++++++++++++++++++
++++++++++++++++++++
++++++++++++++++++++
++++++++++++++++++++
++++++++++++++++++++
++++++++++++++++++++
++++++++++++++++++++
+++++++++++a  ++++++
++++++++++  A ++++++
++++++++++0   +++  +
++++++++++++  +++  +
++++++++++++       +
+++++++++++++     ++
++++++++++++++++++++
