++++++++++++++++++++
++++++++++++++++++++
++++++++++++++++++++
++++++++++++++++++++
++++++++++++++++++++
++++++++++++++++++++
++++++++++++++++++++
++++++++++++++++++++
++++++++++++++++++++
++++++++++++++++++++
++++++++++++++++++++
++++++++++++++++  ++
++++++++++++++++  ++
++++++++++++++++   +
++++++++++++++++   +
++++++++++++++++   +
+++++++++++   Aa0  +
++++++++++++       +
+++++++++++++++++ ++
++++++++++++++++++++
