++++++++++++++++++++
++++++++++++++++++++
++++++++++++++++++++
++++++++++++++++++++
++++++++++++++++++++
++++++++++++++++++++
++++++++++++++++++++
++++++++++++++++++++
++++++++++++++++++++
++++++++++++++++++++
+++++++++++ 0+++  ++
+++++++++++   Aa  ++
+++++++++++       ++
+++++++++++  +++  ++
++++++++++++ +++  ++
++++++++++++++++  ++
++++++++++++++++   +
++++++++++++++++++++
++++++++++++++++++++
++++++++++++++++++++
