++++++++++++++++++++
++++++++++++++++++++
++++++++++++++++++++
++++++++++++++++++++
++++++++++++++++++++
++++++++++++++++++++
++++++++++++++++++++
++++++++++++++++++++
++++++++++++++++++++
++++++++++++++++++++
+++++++++++++++    +
+++++++++++++++    +
+++++++++++++++ A  +
+++++++++++++      +
++++++++++++++a0   +
++++++++++++++++  ++
++++++++++++++++  ++
++++++++++++++++  ++
++++++++++++++++++++
++++++++++++++++++++
