++++++++++++++++++++
++++++++++++++++++++
++++++++++++++++++++
++++++++++++++++++++
++++++++++++++++++++
++++++++++++++++++++
++++++++++++++++++++
++++++++++++++++++++
++++++++++++++++++++
++++++++++++++++++++
++++++++++++++ a  ++
++++++++++  ++    ++
++++++++++      ++++
++++++++++    A ++++
++++++++++  ++  ++++
++++++++++0 ++  ++++
++++++++++  ++  ++++
++++++++++  ++++++++
++++++++++++++++++++
++++++++++++++++++++
