++++++++++++++++++++
++++++++++++++++++++
++++++++++++++++++++
++++++++++++++++++++
++++++++++++++++++++
++++++++++++++++++++
++++++++++++++++++++
++++++++++++++++++++
++++++++++++++++++++
++++++++++++++++++++
++++++++++++++++++++
+++++++++++ ++++++++
+++++++++++aA+++++++
+++++++++++0 +++++++
++++++++++++  ++++++
++++++++++++  +++  +
++++++++++++  +++  +
++++++++++++       +
+++++++++++++     ++
++++++++++++++++++++
