++++++++++++++++++++
++++++++++++++++++++
++++++++++++++++++++
++++++++++++++++++++
++++++++++++++++++++
++++++++++++++++++++
++++++++++++++++++++
++++++++++++++++++++
++++++++++++++++++++
++++++++++++++++++++
++++++++++++++++++++
+++++++++++++++++  +
+++++++++++++++++  +
+++++++++++++++++  +
+++++++++++++++++  +
++++++++++a++++++  +
++++++++++ A 0+++  +
++++++++++         +
++++++++++++++    ++
++++++++++++++++++++
