++++++++++++++++++++
++++++++++++++++++++
++++++++++++++++++++
++++++++++++++++++++
++++++++++++++++++++
++++++++++++++++++++
++++++++++++++++++++
++++++++++++++++++++
++++++++++++++++++++
++++++++++++++++++++
+++++++++++++++  +++
+++++++++++++++0 +++
+++++++++++++++  +++
+++++++++++++++  +++
+++++++++++++++ A  +
+++++++++++++++ a  +
+++++++++++++++    +
+++++++++++++++   ++
++++++++++++++++ +++
++++++++++++++++++++
