++++++++++++++++++++
++++++++++++++++++++
++++++++++++++++++++
++++++++++++++++++++
++++++++++++++++++++
++++++++++++++++++++
++++++++++++++++++++
++++++++++++++++++++
++++++++++++++++++++
++++++++++++++++++++
++++++++++++++++++++
+++++++++++++ ++++++
+++++++++++++  +++++
+++++++++++++  +++++
+++++++++++++  +++++
+++++++++++++  0  ++
+++++++++++++  Aa  +
+++++++++++++  +   +
+++++++++++++++++ ++
++++++++++++++++++++
