++++++++++++++++++++
++++++++++++++++++++
++++++++++++++++++++
++++++++++++++++++++
++++++++++++++++++++
++++++++++++++++++++
++++++++++++++++++++
++++++++++++++++++++
++++++++++++++++++++
++++++++++++++++++++
+++++++++++++++++  +
+++++++++++++++++  +
+++++++++++++++++  +
+++++++++++++++++  +
++++++++++ 0 ++++  +
+++++++++++   a    +
+++++++++++++  A   +
+++++++++++++++++  +
+++++++++++++++++ ++
++++++++++++++++++++
