++++++++++++++++++++
++++++++++++++++++++
++++++++++++++++++++
++++++++++++++++++++
++++++++++++++++++++
++++++++++++++++++++
++++++++++++++++++++
++++++++++++++++++++
++++++++++++++++++++
++++++++++++++++++++
++++++++++++++++++++
++++++++++++++++++++
++++++++++++++++++++
+++++++++++ 0  +++++
+++++++++++A   +++++
+++++++++++  a +++++
+++++++++++    +++++
+++++++++++    +++++
++++++++++++ +++++++
++++++++++++++++++++
