++++++++++++++++++++
++++++++++++++++++++
++++++++++++++++++++
++++++++++++++++++++
++++++++++++++++++++
++++++++++++++++++++
++++++++++++++++++++
++++++++++++++++++++
++++++++++++++++++++
++++++++++++++++++++
+++++++++++++++++  +
++++++++++++++++   +
++++++++++++++++A  +
++++++++++++++++   +
++++++++++  ++++  ++
+++++++++++a   0  ++
++++++++++++      ++
++++++++++++++++  ++
++++++++++++++++++++
++++++++++++++++++++
