++++++++++++++++++++
++++++++++++++++++++
++++++++++++++++++++
++++++++++++++++++++
++++++++++++++++++++
++++++++++++++++++++
++++++++++++++++++++
++++++++++++++++++++
++++++++++++++++++++
++++++++++++++++++++
+++++++++++++  ++  +
+++++++++++++  ++  +
+++++++++++++0A++  +
+++++++++++++  ++  +
+++++++++++++   +  +
++++++++++++++a    +
+++++++++++++++    +
+++++++++++++++++  +
+++++++++++++++++ ++
++++++++++++++++++++
