++++++++++++++++++++
++++++++++++++++++++
++++++++++++++++++++
++++++++++++++++++++
++++++++++++++++++++
++++++++++++++++++++
++++++++++++++++++++
++++++++++++++++++++
++++++++++++++++++++
++++++++++++++++++++
++++++++++   +++++++
++++++++++    ++++++
++++++++++  a ++++++
++++++++++ +  ++++++
++++++++++++      ++
++++++++++++  A    +
++++++++++++0 +++  +
++++++++++++  +++  +
++++++++++++++++++++
++++++++++++++++++++
