++++++++++++++++++++
++++++++++++++++++++
++++++++++++++++++++
++++++++++++++++++++
++++++++++++++++++++
++++++++++++++++++++
++++++++++++++++++++
++++++++++++++++++++
++++++++++++++++++++
++++++++++++++++++++
++++++++++++0   +  +
++++++++++++       +
+++++++++++++++    +
+++++++++++++++a   +
+++++++++++++++    +
+++++++++++++++    +
++++++++++++++++A  +
+++++++++++++++++  +
+++++++++++++++++ ++
++++++++++++++++++++
