++++++++++++++++++++
++++++++++++++++++++
++++++++++++++++++++
++++++++++++++++++++
++++++++++++++++++++
++++++++++++++++++++
++++++++++++++++++++
++++++++++++++++++++
++++++++++++++++++++
++++++++++++++++++++
++++++++++++++++  ++
++++++++++++++++0 ++
++++++++++++++++A ++
++++++++++++++++  ++
++++++++++++++++a  +
++++++++++++++++   +
++++++++++++++++   +
+++++++++++++++++  +
+++++++++++++++++ ++
++++++++++++++++++++
