++++++++++++++++++++
++++++++++++++++++++
++++++++++++++++++++
++++++++++++++++++++
++++++++++++++++++++
++++++++++++++++++++
++++++++++++++++++++
++++++++++++++++++++
++++++++++++++++++++
++++++++++++++++++++
++++++++++++++++++++
+++++++++++++++++  +
+++++++++++++++++  +
++++++++++++0  ++  +
++++++++++++aA  +  +
+++++++++++  +  +  +
++++++++++++ +  +  +
++++++++++++++    ++
+++++++++++++++   ++
++++++++++++++++++++
