++++++++++++++++++++
++++++++++++++++++++
++++++++++++++++++++
++++++++++++++++++++
++++++++++++++++++++
++++++++++++++++++++
++++++++++++++++++++
++++++++++++++++++++
++++++++++++++++++++
++++++++++++++++++++
++++++++++++++++++++
++++++++++++++++++++
+++++++++++++++++  +
++++++++++++++  A  +
+++++++++++++a     +
++++++++++++++ 0   +
++++++++++++++++   +
++++++++++++++++  ++
+++++++++++++++++ ++
++++++++++++++++++++
