++++++++++++++++++++
++++++++++++++++++++
++++++++++++++++++++
++++++++++++++++++++
++++++++++++++++++++
++++++++++++++++++++
++++++++++++++++++++
++++++++++++++++++++
++++++++++++++++++++
++++++++++++++++++++
+++++++++++++ A a  +
+++++++++++++      +
+++++++++++++      +
+++++++++++++     ++
+++++++++++++   + ++
++++++++++++++0 ++++
++++++++++++++  ++++
++++++++++++++  ++++
++++++++++++++++++++
++++++++++++++++++++
