++++++++++++++++++++
++++++++++++++++++++
++++++++++++++++++++
++++++++++++++++++++
++++++++++++++++++++
++++++++++++++++++++
++++++++++++++++++++
++++++++++++++++++++
++++++++++++++++++++
++++++++++++++++++++
+++++++++++++  +++++
+++++++++++++0 +++++
++++++++++++a   ++++
++++++++++++    ++++
+++++++++++     ++++
++++++++++++ +  ++++
++++++++++++++A ++++
++++++++++++++    ++
+++++++++++++++   ++
++++++++++++++++++++
