++++++++++++++++++++
++++++++++++++++++++
++++++++++++++++++++
++++++++++++++++++++
++++++++++++++++++++
++++++++++++++++++++
++++++++++++++++++++
++++++++++++++++++++
++++++++++++++++++++
++++++++++++++++++++
++++++++++++++++A  +
++++++++++++++++   +
++++++++++++++++a  +
+++++++++++++++    +
+++++++++++++++    +
+++++++++++++++  +++
+++++++++++++++ 0+++
++++++++++++++++++++
++++++++++++++++++++
++++++++++++++++++++
