++++++++++++++++++++
++++++++++++++++++++
++++++++++++++++++++
++++++++++++++++++++
++++++++++++++++++++
++++++++++++++++++++
++++++++++++++++++++
++++++++++++++++++++
++++++++++++++++++++
++++++++++++++++++++
++++++++++++A0   +++
++++++++++++ a   +++
++++++++++++  +  +++
++++++++++++  +  +++
++++++++++++ ++  +++
+++++++++++++++  +++
+++++++++++++++  +++
++++++++++++++++++++
++++++++++++++++++++
++++++++++++++++++++
