++++++++++++++++++++
++++++++++++++++++++
++++++++++++++++++++
++++++++++++++++++++
++++++++++++++++++++
++++++++++++++++++++
++++++++++++++++++++
++++++++++++++++++++
++++++++++++++++++++
++++++++++++++++++++
+++++++++++++++++  +
+++++++++++++++ A  +
++++++++++++++++a  +
++++++++++++++++   +
++++++++++++++++   +
++++++++++++++++0  +
++++++++++++++++   +
++++++++++++++++   +
+++++++++++++++++ ++
++++++++++++++++++++
