++++++++++++++++++++
++++++++++++++++++++
++++++++++++++++++++
++++++++++++++++++++
++++++++++++++++++++
++++++++++++++++++++
++++++++++++++++++++
++++++++++++++++++++
++++++++++++++++++++
++++++++++++++++++++
++++++++++++++  ++++
+++++++++++++   a+++
+++++++++++++    +++
+++++++++++++ A  +++
+++++++++++++    +++
+++++++++++++   0+++
++++++++++++++    ++
+++++++++++++++    +
++++++++++++++++++++
++++++++++++++++++++
