++++++++++++++++++++
++++++++++++++++++++
++++++++++++++++++++
++++++++++++++++++++
++++++++++++++++++++
++++++++++++++++++++
++++++++++++++++++++
++++++++++++++++++++
++++++++++++++++++++
++++++++++++++++++++
+++++++++++   0    +
+++++++++++       ++
+++++++++++  +++++++
+++++++++++ a+++++++
+++++++++++  +++++++
+++++++++++  +++++++
+++++++++++ A+++++++
+++++++++++  +++++++
++++++++++++++++++++
++++++++++++++++++++
