++++++++++++++++++++
++++++++++++++++++++
++++++++++++++++++++
++++++++++++++++++++
++++++++++++++++++++
++++++++++++++++++++
++++++++++++++++++++
++++++++++++++++++++
++++++++++++++++++++
++++++++++++++++++++
+++++++++++++++++  +
+++++++++++  0    ++
+++++++++++       ++
+++++++++++    +++++
+++++++++++    +++++
+++++++++++ A  +++++
++++++++++++  a+++++
+++++++++++++  +++++
++++++++++++++++++++
++++++++++++++++++++
