++++++++++++++++++++
++++++++++++++++++++
++++++++++++++++++++
++++++++++++++++++++
++++++++++++++++++++
++++++++++++++++++++
++++++++++++++++++++
++++++++++++++++++++
++++++++++++++++++++
++++++++++++++++++++
+++++++++++++++++  +
+++++++++++A+++++  +
+++++++++++ a++++  +
+++++++++++0 ++++  +
+++++++++++  ++++  +
+++++++++++  ++++  +
+++++++++++  ++++  +
+++++++++++       ++
++++++++++++      ++
++++++++++++++++++++
