++++++++++++++++++++
++++++++++++++++++++
++++++++++++++++++++
++++++++++++++++++++
++++++++++++++++++++
++++++++++++++++++++
++++++++++++++++++++
++++++++++++++++++++
++++++++++++++++++++
++++++++++++++++++++
+++++++++++++  ++  +
+++++++++++++  +   +
+++++++++++++      +
+++++++++++++ a    +
+++++++++++++  ++  +
+++++++++++++A0+++++
+++++++++++++ ++++++
++++++++++++++++++++
++++++++++++++++++++
++++++++++++++++++++
