++++++++++++++++++++
++++++++++++++++++++
++++++++++++++++++++
++++++++++++++++++++
++++++++++++++++++++
++++++++++++++++++++
++++++++++++++++++++
++++++++++++++++++++
++++++++++++++++++++
++++++++++++++++++++
++++++++++++++++++++
++++++++++++++++++++
++++++++++++++++++++
+++++++++++++++a +++
+++++++++++++++A   +
++++++++++++++     +
++++++++++++++0    +
++++++++++++++     +
++++++++++++++++  ++
++++++++++++++++++++
