++++++++++++++++++++
++++++++++++++++++++
++++++++++++++++++++
++++++++++++++++++++
++++++++++++++++++++
++++++++++++++++++++
++++++++++++++++++++
++++++++++++++++++++
++++++++++++++++++++
++++++++++++++++++++
+++++++++++  +++++++
+++++++++++  +++++++
+++++++++++0     +++
+++++++++++   a A+++
+++++++++++  ++   ++
+++++++++++  +++  ++
+++++++++++  +++  ++
++++++++++++++++  ++
+++++++++++++++++ ++
++++++++++++++++++++
