++++++++++++++++++++
++++++++++++++++++++
++++++++++++++++++++
++++++++++++++++++++
++++++++++++++++++++
++++++++++++++++++++
++++++++++++++++++++
++++++++++++++++++++
++++++++++++++++++++
++++++++++++++++++++
++++++++++++++++++++
+++++++++++++++++  +
+++++++++++++++++  +
+++++++++++++++++  +
++++++++++   ++++  +
++++++++++  A++++  +
++++++++++  a+  0 ++
++++++++++        ++
+++++++++++    +++++
++++++++++++++++++++
