++++++++++++++++++++
++++++++++++++++++++
++++++++++++++++++++
++++++++++++++++++++
++++++++++++++++++++
++++++++++++++++++++
++++++++++++++++++++
++++++++++++++++++++
++++++++++++++++++++
++++++++++++++++++++
++++++++++++   +++++
++++++++++++    ++++
++++++++++ +0   ++++
++++++++++ a    ++++
++++++++++      ++++
++++++++++     A++++
+++++++++++   + ++++
+++++++++++  +++++++
++++++++++++ +++++++
++++++++++++++++++++
