++++++++++++++++++++
++++++++++++++++++++
++++++++++++++++++++
++++++++++++++++++++
++++++++++++++++++++
++++++++++++++++++++
++++++++++++++++++++
++++++++++++++++++++
++++++++++++++++++++
++++++++++++++++++++
++++++++++++   +++++
++++++++++++  0+++++
++++++++++++  ++++++
+++++++++++   ++++++
+++++++++++   ++++++
+++++++++++   ++++++
+++++++++++A a++++++
+++++++++++  +++++++
++++++++++++ +++++++
++++++++++++++++++++
