++++++++++++++++++++
++++++++++++++++++++
++++++++++++++++++++
++++++++++++++++++++
++++++++++++++++++++
++++++++++++++++++++
++++++++++++++++++++
++++++++++++++++++++
++++++++++++++++++++
++++++++++++++++++++
++++++++++  ++++++++
++++++++++   +++++++
++++++++++   +++++++
++++++++++  A+++++++
++++++++++   +++++++
++++++++++  a+++++++
+++++++++++   0   ++
+++++++++++       ++
++++++++++++++++++++
++++++++++++++++++++
