++++++++++++++++++++
++++++++++++++++++++
++++++++++++++++++++
++++++++++++++++++++
++++++++++++++++++++
++++++++++++++++++++
++++++++++++++++++++
++++++++++++++++++++
++++++++++++++++++++
++++++++++++++++++++
++++++++++++++++++++
++++++++++++ +++++++
++++++++++++    ++++
++++++++++++  0 ++++
++++++++++++    ++++
++++++++++++A   +  +
++++++++++++ a     +
++++++++++++       +
+++++++++++++ ++++++
++++++++++++++++++++
