++++++++++++++++++++
++++++++++++++++++++
++++++++++++++++++++
++++++++++++++++++++
++++++++++++++++++++
++++++++++++++++++++
++++++++++++++++++++
++++++++++++++++++++
++++++++++++++++++++
++++++++++++++++++++
++++++++++++++++++++
+++++++++++++++++  +
+++++++++++++++++  +
+++++++++++  0     +
++++++++++++   aA  +
++++++++++++++++   +
++++++++++++++++   +
+++++++++++++++++  +
+++++++++++++++++ ++
++++++++++++++++++++
