++++++++++++++++++++
++++++++++++++++++++
++++++++++++++++++++
++++++++++++++++++++
++++++++++++++++++++
++++++++++++++++++++
++++++++++++++++++++
++++++++++++++++++++
++++++++++++++++++++
++++++++++++++++++++
+++++++++++++++ 0  +
++++++++++++++  A  +
+++++++++++++++    +
+++++++++++++++ a  +
+++++++++++++++    +
+++++++++++++++    +
++++++++++++++++   +
+++++++++++++++++  +
++++++++++++++++++++
++++++++++++++++++++
