++++++++++++++++++++
++++++++++++++++++++
++++++++++++++++++++
++++++++++++++++++++
++++++++++++++++++++
++++++++++++++++++++
++++++++++++++++++++
++++++++++++++++++++
++++++++++++++++++++
++++++++++++++++++++
+++++++++++++++++  +
+++++++++++++++++  +
++++++++++++++++   +
++++++++++++++++0  +
++++++++++++++++a  +
++++++++++++++++   +
++++++++++++++++A  +
++++++++++++++++  ++
++++++++++++++++++++
++++++++++++++++++++
