++++++++++++++++++++
++++++++++++++++++++
++++++++++++++++++++
++++++++++++++++++++
++++++++++++++++++++
++++++++++++++++++++
++++++++++++++++++++
++++++++++++++++++++
++++++++++++++++++++
++++++++++++++++++++
+++++++++++   ++++++
+++++++++++   ++++++
+++++++++++   ++++++
+++++++++++  a++++++
+++++++++++    A  ++
+++++++++++ 0      +
+++++++++++  ++++  +
+++++++++++  ++++  +
+++++++++++++++++ ++
++++++++++++++++++++
