++++++++++++++++++++
++++++++++++++++++++
++++++++++++++++++++
++++++++++++++++++++
++++++++++++++++++++
++++++++++++++++++++
++++++++++++++++++++
++++++++++++++++++++
++++++++++++++++++++
++++++++++++++++++++
++++++++++++++++++++
++++++++++++++a+++++
++++++++++++++  +  +
++++++++++++++A +  +
++++++++++++++     +
++++++++++++++     +
++++++++++++++0 +  +
+++++++++++++++ +  +
++++++++++++++++++++
++++++++++++++++++++
