++++++++++++++++++++
++++++++++++++++++++
++++++++++++++++++++
++++++++++++++++++++
++++++++++++++++++++
++++++++++++++++++++
++++++++++++++++++++
++++++++++++++++++++
++++++++++++++++++++
++++++++++++++++++++
++++++++++++++    ++
+++++++++++++    +++
+++++++++++++    +++
+++++++++++++   ++++
+++++++++++++ A ++++
++++++++++++++  ++++
++++++++++++++0a++++
++++++++++++++  ++++
++++++++++++++++++++
++++++++++++++++++++
