++++++++++++++++++++
++++++++++++++++++++
++++++++++++++++++++
++++++++++++++++++++
++++++++++++++++++++
++++++++++++++++++++
++++++++++++++++++++
++++++++++++++++++++
++++++++++++++++++++
++++++++++++++++++++
++++++++++++++A ++++
++++++++++++++  ++++
++++++++++++++  ++++
++++++++++++++0a++++
++++++++++++++  ++++
++++++++++++++  ++++
++++++++++++++    ++
++++++++++++++    ++
+++++++++++++++   ++
++++++++++++++++++++
