++++++++++++++++++++
++++++++++++++++++++
++++++++++++++++++++
++++++++++++++++++++
++++++++++++++++++++
++++++++++++++++++++
++++++++++++++++++++
++++++++++++++++++++
++++++++++++++++++++
++++++++++++++++++++
++++++++++ 0++++++++
++++++++++   +++++++
+++++++++++  +++++++
+++++++++++  ++  +++
+++++++++++a ++A +++
+++++++++++  ++  +++
+++++++++++  ++  +++
+++++++++++        +
++++++++++++      ++
++++++++++++++++++++
