++++++++++++++++++++
++++++++++++++++++++
++++++++++++++++++++
++++++++++++++++++++
++++++++++++++++++++
++++++++++++++++++++
++++++++++++++++++++
++++++++++++++++++++
++++++++++++++++++++
++++++++++++++++++++
+++++++++++++++++  +
+++++++++++++++++  +
++++++++++++++  +  +
++++++++++++++  +  +
++++++++++++++    ++
++++++++++  a A   ++
+++++++++++   0 ++++
++++++++++++++  ++++
++++++++++++++++++++
++++++++++++++++++++
