++++++++++++++++++++
++++++++++++++++++++
++++++++++++++++++++
++++++++++++++++++++
++++++++++++++++++++
++++++++++++++++++++
++++++++++++++++++++
++++++++++++++++++++
++++++++++++++++++++
++++++++++++++++++++
++++++++++++++++++++
+++++++++++++    +++
++++++++++A   a   ++
+++++++++++   ++  ++
++++++++++++++++  ++
++++++++++++++++   +
++++++++++++++++0  +
++++++++++++++++   +
+++++++++++++++++ ++
++++++++++++++++++++
