++++++++++++++++++++
++++++++++++++++++++
++++++++++++++++++++
++++++++++++++++++++
++++++++++++++++++++
++++++++++++++++++++
++++++++++++++++++++
++++++++++++++++++++
++++++++++++++++++++
++++++++++++++++++++
+++++++++++++ a+++++
+++++++++++++  +++++
+++++++++++++  +++++
+++++++++++++  +++++
+++++++++++++  +++++
+++++++++++++A +++++
+++++++++++++ 0+++++
+++++++++++++      +
++++++++++++++    ++
++++++++++++++++++++
