++++++++++++++++++++
++++++++++++++++++++
++++++++++++++++++++
++++++++++++++++++++
++++++++++++++++++++
++++++++++++++++++++
++++++++++++++++++++
++++++++++++++++++++
++++++++++++++++++++
++++++++++++++++++++
++++++++++++++++0 ++
++++++++++++++++  ++
++++++++++++++++a ++
++++++++++++++++   +
++++++++++++++++A  +
++++++++++++++++   +
++++++++++++++++   +
++++++++++++++++   +
+++++++++++++++++ ++
++++++++++++++++++++
