++++++++++++++++++++
++++++++++++++++++++
++++++++++++++++++++
++++++++++++++++++++
++++++++++++++++++++
++++++++++++++++++++
++++++++++++++++++++
++++++++++++++++++++
++++++++++++++++++++
++++++++++++++++++++
+++++++++++  +++++++
+++++++++++ 0+++++++
+++++++++++  +++++++
++++++++++   +++++++
++++++++++ a +++++++
++++++++++   +++++++
++++++++++   A +++++
+++++++++++       ++
++++++++++++      ++
++++++++++++++++++++
