++++++++++++++++++++
++++++++++++++++++++
++++++++++++++++++++
++++++++++++++++++++
++++++++++++++++++++
++++++++++++++++++++
++++++++++++++++++++
++++++++++++++++++++
++++++++++++++++++++
++++++++++++++++++++
++++++++++++++     +
++++++++++++++  0  +
++++++++++++++  ++++
++++++++++++++a ++++
++++++++++++ +  ++++
++++++++++++    ++++
+++++++++++++  A++++
++++++++++++++  ++++
++++++++++++++++++++
++++++++++++++++++++
