++++++++++++++++++++
++++++++++++++++++++
++++++++++++++++++++
++++++++++++++++++++
++++++++++++++++++++
++++++++++++++++++++
++++++++++++++++++++
++++++++++++++++++++
++++++++++++++++++++
++++++++++++++++++++
+++++++++++++++++  +
+++++++++++++++++  +
++++++++++++++A++  +
++++++++++++++ a+  +
++++++++++++++ 0+  +
++++++++++++++  +  +
++++++++++++++  +  +
++++++++++++++     +
+++++++++++++++   ++
++++++++++++++++++++
