++++++++++++++++++++
++++++++++++++++++++
++++++++++++++++++++
++++++++++++++++++++
++++++++++++++++++++
++++++++++++++++++++
++++++++++++++++++++
++++++++++++++++++++
++++++++++++++++++++
++++++++++++++++++++
++++++++++  ++++++++
++++++++++A ++++++++
++++++++++  +++++  +
++++++++++a +++++  +
++++++++++  +++++  +
++++++++++  +++    +
++++++++++0 +      +
++++++++++      +  +
+++++++++++   +++ ++
++++++++++++++++++++
