++++++++++++++++++++
++++++++++++++++++++
++++++++++++++++++++
++++++++++++++++++++
++++++++++++++++++++
++++++++++++++++++++
++++++++++++++++++++
++++++++++++++++++++
++++++++++++++++++++
++++++++++++++++++++
+++++++++++++     ++
+++++++++++++ a    +
+++++++++++++  ++  +
+++++++++++++A ++  +
+++++++++++++0 ++  +
++++++++++++  +++  +
++++++++++++  +++  +
++++++++++++++++++++
++++++++++++++++++++
++++++++++++++++++++
