++++++++++++++++++++
++++++++++++++++++++
++++++++++++++++++++
++++++++++++++++++++
++++++++++++++++++++
++++++++++++++++++++
++++++++++++++++++++
++++++++++++++++++++
++++++++++++++++++++
++++++++++++++++++++
+++++++++++    +++++
++++++++++++    ++++
++++++++++++++  ++++
++++++++++++++  A ++
++++++++++++++a 0  +
++++++++++++++     +
+++++++++++++++ +  +
+++++++++++++++++  +
++++++++++++++++++++
++++++++++++++++++++
