++++++++++++++++++++
++++++++++++++++++++
++++++++++++++++++++
++++++++++++++++++++
++++++++++++++++++++
++++++++++++++++++++
++++++++++++++++++++
++++++++++++++++++++
++++++++++++++++++++
++++++++++++++++++++
++++++++++++++++a  +
++++++++++++++++   +
++++++++++++++++   +
++++++++++++++++   +
++++++++++++++++   +
+++++++++++++++A   +
+++++++++++++++ 0 ++
++++++++++++++++++++
++++++++++++++++++++
++++++++++++++++++++
