++++++++++++++++++++
++++++++++++++++++++
++++++++++++++++++++
++++++++++++++++++++
++++++++++++++++++++
++++++++++++++++++++
++++++++++++++++++++
++++++++++++++++++++
++++++++++++++++++++
++++++++++++++++++++
+++++++++++a0   +  +
+++++++++++     +  +
++++++++++++++  +  +
++++++++++++++  +  +
++++++++++++++  +  +
++++++++++++++  +  +
++++++++++++++A +  +
++++++++++++++     +
+++++++++++++++   ++
++++++++++++++++++++
