++++++++++++++++++++
++++++++++++++++++++
++++++++++++++++++++
++++++++++++++++++++
++++++++++++++++++++
++++++++++++++++++++
++++++++++++++++++++
++++++++++++++++++++
++++++++++++++++++++
++++++++++++++++++++
+++++++++++++   ++++
++++++++++      ++++
+++++++++++ 0   +  +
++++++++++++++  +  +
++++++++++++++  +  +
++++++++++++++ aA  +
++++++++++++++     +
++++++++++++++  +  +
++++++++++++++++++++
++++++++++++++++++++
