++++++++++++++++++++
++++++++++++++++++++
++++++++++++++++++++
++++++++++++++++++++
++++++++++++++++++++
++++++++++++++++++++
++++++++++++++++++++
++++++++++++++++++++
++++++++++++++++++++
++++++++++++++++++++
+++++++++++++++0   +
+++++++++++++++   ++
+++++++++++     ++++
+++++++++++   A ++++
+++++++++++  +++++++
+++++++++++ a+++++++
+++++++++++  +++++++
+++++++++++  +++++++
++++++++++++++++++++
++++++++++++++++++++
