++++++++++++++++++++
++++++++++++++++++++
++++++++++++++++0  +
++++++++++++++++   +
++++++++++++++++   +
++++++++++ +++++   +
++++++++++      +  +
+++++++++++        +
+++++++++++++++    +
+++++++  ++++++    +
+++++++   +++++    +
+++++++   +   +    +
+++++++   +   a    +
++++++++  +        +
++++++++       A   +
++++++++  +        +
++++++++    +++    +
+++++++++   +++    +
++++++++++++++++++++
++++++++++++++++++++
