++++++++++++++++++++
++++++++++++++++++++
++++            +  +
++++               +
++++  +++          +
++++  +++  + 0     +
++++  +++  +      ++
+++A +  +  +      ++
++++ +  +  +    ++++
++++      ++    +  +
++++            +  +
++++      a     +  +
++++  +  ++++  ++  +
++++  +  +++++ ++  +
++++  +++++++++++  +
++++ +++++++    +  +
+++++++++          +
++++++++++   ++    +
++++++++++++++++  ++
++++++++++++++++++++
