++++++++++++++++++++
++++++++++++++++++++
+++      ++++   ++++
+++       +++    +++
+++  +++  +++   ++++
+++ ++++        ++++
++   +++         +++
++               +++
++            +   ++
++    +++++   +    +
++  ++++++    +    +
++  ++++++   a     +
++  +++      A    ++
++  +++       ++  ++
++  +++0 +     +  ++
++   ++    +++    ++
+++    +   +++    ++
++++             +++
+++++            +++
++++++++++++++++++++
