++++++++++++++++++++
++++++++++++++++++++
+++++++++  +++   +++
+++  +++    ++   +++
+++  +++    ++  ++++
+++  +++     +  +  +
+++a +++           +
+++  + A           +
+++  +             +
+++             +  +
+++        +   ++  +
+++        ++ 0++  +
+++       +++  ++  +
+++           +++  +
+++           ++++++
+++     ++++++++++++
+++     +  +++++++++
+++++     ++++++++++
++++++    ++++++++++
++++++++++++++++++++
