++++++++++++++++++++
++++++++++++++++++++
+++++++++  + +  +  +
++++++++           +
+++++++++   +      +
++++++++++         +
+++      0 a       +
+++                +
+++  ++++++++      +
+++  ++++++++      +
+++  +++++  +  ++  +
++++++++++     +  ++
+++++++++++    +  ++
+++++++++++       ++
+++++++++         ++
+++++++++A        ++
++++++++   +      ++
+++++++++  ++     ++
++++++++++++++ +++++
++++++++++++++++++++
