++++++++++++++++++++
++++++++++++++++++++
++++++++++ +++++++++
++++++++    ++++++++
++++++++     +++++++
++++++++        ++++
++++++++         +++
++++++++  a0  +  +++
++++++++      +    +
++++++++      +    +
++++++++      A    +
++++        +      +
++++      +++++    +
++++  ++  +++++++  +
++++  +++++++++    +
++++  +++++++      +
++++  +++++++     ++
+++++++++++++     ++
++++++++++++++    ++
++++++++++++++++++++
