++++++++++++++++++++
++++++++++++++++++++
++++++++++++       +
+++++++++  +      ++
+++++++++  +  +++  +
+++++++++  +  +++  +
+++++++++  +  +++  +
+++++++++  +  +++  +
++++++  +  +  +++  +
++++++  + 0+  +++  +
+++a++     ++  +   +
+++        ++  +   +
++++        +      +
++++++  ++         +
++++++  +++       ++
+++++  +++++++A ++++
++++++ +++++++  ++++
++++++++++++++++++++
++++++++++++++++++++
++++++++++++++++++++
