++++++++++++++++++++
++++++++++++++++++++
+++   0         ++++
+++  A           +++
+++  +++++  ++     +
+++  +++++      +  +
++   +++++      +  +
+++  +++++    +++  +
+++  +++++    +++  +
++++++++           +
++++++++ a         +
+++++++++          +
+++++++++  +   +   +
+++++++++++++      +
++++++++           +
+++++++++          +
+++++++++++++++++  +
+++++++++++++++++  +
+++++++++++++++++ ++
++++++++++++++++++++
