++++++++++++++++++++
++++++++++++++++++++
+++++++++++++++++  +
+++++++++++++++++  +
+++++++++++++++    +
++++++++++++       +
++++++++++++    0  +
+++++++++++++ +++  +
++++++++++++++++   +
++++++++++++++++   +
++++++++++++++++   +
++++++++++++++     +
++++++++++++++     +
++++++++++++  a A  +
+++++++++++++      +
++++++++++++++++   +
+++++++++ ++++++   +
+++++++++          +
++++++++++        ++
++++++++++++++++++++
