++++++++++++++++++++
++++++++++++++++++++
+++        +  0 ++++
++++             +++
+++++            +++
+++++     +++    +++
+++++    ++++     ++
++++++   +++++     +
++++ +  +++++++    +
++++A   +++++++    +
++++    ++++++++   +
++++    ++++++++   +
++++    ++++++++   +
++++   ++++     +  +
+++++         a    +
++++++++     ++    +
+++                +
++++               +
++++++++++++++++  ++
++++++++++++++++++++
