++++++++++++++++++++
++++++++++++++++++++
+++++  +  +   ++++++
+++++         ++  ++
+++++        +++  ++
+++++ +++++0 +++   +
+++++++++++        +
+++++++++++  +     +
+++++++++++        +
++++++++++  +      +
++  ++++++     ++  +
+++ a++        ++  +
+++   ++       ++  +
+++   +        ++  +
+++           +++  +
+++        A   ++  +
++++           ++  +
+++++     +   +++ ++
++++++++ +++  ++++++
++++++++++++++++++++
