++++++++++++++++++++
++++++++++++++++++++
+++++++  +       +++
+++++++  +    +  +++
+++      +  +++    +
+++           A    +
+++        +       +
+++   +   +++++    +
+++   ++     ++    +
+++   ++     ++    +
++++  ++     ++a   +
++++  +++          +
++++++++           +
+++++++++   +++++  +
+++++++++  ++++++  +
+++++++++ 0++++++  +
+++++++++      ++  +
++++++++++     ++  +
++++++++++++++++++++
++++++++++++++++++++
