++++++++++++++++++++
++++++++++++++++++++
++++++++++++  a ++++
++++++++  ++      ++
++++++++  ++  A    +
+++++     ++   ++  +
+++       ++   ++  +
++++   +  +++  +   +
++++++++  +++      +
++++++++  +++      +
++++++++  +++  ++  +
++++++++       ++  +
+++++++++       +  +
+++++++++++++      +
+++++++++++++  0   +
+++++      ++      +
++                 +
+++     ++        ++
+++++++++++       ++
++++++++++++++++++++
