++++++++++++++++++++
++++++++++++++++++++
++0+++++++++       +
++                 +
+++          ++++  +
++++++  +++++++++  +
++++++  +++++++++  +
++++++    +A       +
++++++       a     +
++++++         ++  +
++++++       +  +  +
+++++++      +     +
++++++++   +++     +
++         +  +++  +
++         +  +++  +
+++++++       ++   +
++++++++           +
+++++++++++++      +
++++++++++++++++++++
++++++++++++++++++++
