++++++++++++++++++++
++++++++++++++++++++
++++++++  ++ 0 a   +
++++++++   +       +
++++++++   +       +
++++++++   +  +++  +
++++++     +  ++++++
++++++     +  ++++++
++++++     + +++++++
++++++     +       +
++++ +  +  +       +
++++    +  +  +++  +
++++    +   A++    +
++++    ++   +++   +
++++    +++++++++  +
++++    +++++++++  +
++++    +++++++++  +
++++    +++++++++  +
+++++ +++++++++++ ++
++++++++++++++++++++
