++++++++++++++++++++
++++++++++++++++++++
+++++       +++++  +
+++++        ++++  +
+++++              +
+++    A  +       ++
+++       +  +    ++
+++++  a  ++++  ++++
+++++  +  ++++  ++++
+++++  +  ++++  ++++
+++++  +++++++  +  +
+++++  +++++++  +  +
+++++  +++++++     +
+++++  +++++++     +
+++++  +        +  +
+++++        0  +  +
+++++  + +     ++  +
+++++  ++++    +++++
++++++++++++++++++++
++++++++++++++++++++
