++++++++++++++++++++
++++++++++++++++++++
+++++++++++++++++  +
++++++++++++++++   +
++++++++++++++++   +
++++++++++++++++   +
++++++++++++++++a  +
++++++++++++++++   +
+++++++++++++++    +
+++++++++++++++    +
++++++++++++ ++    +
++++++++++++  + +  +
++++++++++++   ++  +
++++++++++++       +
+++++++++++++A     +
++++++++++         +
+++++++++++  0     +
+++++++++++++      +
+++++++++++++++++ ++
++++++++++++++++++++
