++++++++++++++++++++
++++++++++++++++++++
++++++     +++++   +
++++++      ++++   +
++++++  ++  +      +
++++++  ++     +   +
+++++  ++++    ++  +
+++++  ++++++      +
+++++  +++++++ 0   +
+++++  ++++        +
+++++  ++++        +
+++++  ++++ ++++   +
++++  ++++++++++   +
+++++ +++++++++    +
+++++  ++++        +
+++++a ++         ++
+++++      A+++ ++++
+++++     ++++++++++
++++++ +++++++++++++
++++++++++++++++++++
