++++++++++++++++++++
++++++++++++++++++++
++++++++++  ++++++++
++++++++++  ++++++++
++++++++++        ++
++++++++++         +
+++++++++++++++++  +
+++++++++++++++++  +
+++++++++   +++++  +
+++++  ++   +++++  +
+++++  ++   +++++  +
+++++  ++   +++++  +
+++++   a    ++++  +
+++++         0    +
++ A               +
++           +++   +
++ +++      ++++   +
++++++      ++++   +
+++++++++++++++++ ++
++++++++++++++++++++
