++++++++++++++++++++
++++++++++++++++++++
++++   +++++++  ++++
++++0   ++++++  ++++
++++    ++++++  ++++
++++       +   +++++
++++           +++++
++++  +       ++++++
++++  +   +   ++++++
++  A ++  ++++ +++++
++    ++ a++++  +  +
++   +++  ++++  +  +
++     +  ++++  +  +
++  ++    ++++  +  +
++++++    +++      +
++++++             +
++++++             +
++++++        ++   +
+++++++++     +++ ++
++++++++++++++++++++
