++++++++++++++++++++
++++++++++++++++++++
++++++++++     ++  +
++++++++++A        +
++++++++++  ++     +
++++++++++  ++     +
++++++++++  ++     +
++++++++++  ++     +
++++++++++      +  +
+++++++++    a     +
++++++++++0        +
++++++++  +++  ++  +
++++++++  +++  ++  +
++++++++  +++  ++  +
++++++++  +++  ++  +
++++++++           +
++++++++  +        +
++++++++      +++  +
+++++++++   +++++ ++
++++++++++++++++++++
