++++++++++++++++++++
++++++++++++++++++++
+++++++++++++++    +
+++++++++++++++ 0  +
++++++++  +++++    +
++++++++           +
++++++  +          +
+++     +++++++    +
++++ A  +++++++    +
++++++  ++  +++    +
++++++      +++    +
+++++++a    +      +
+++++++++++        +
+++++++ +++        +
+++++++  ++        +
+++++++  ++    ++  +
+++++++        ++  +
+++++++            +
++++++++++ +      ++
++++++++++++++++++++
