++++++++++++++++++++
++++++++++++++++++++
++++++++++++++++++++
++++++++++ ++++  +++
++++++++++  +++    +
++++++++++         +
+++++++++++    Aa  +
++++++++++         +
+++++++++++        +
++++++ ++++++++    +
++++    +++++++    +
++++    +++++++    +
++++    ++++ ++    +
++++           0   +
++++  +            +
++++  ++      +    +
++++            ++++
++++      +++   ++++
++++++++++++++++++++
++++++++++++++++++++
