++++++++++++++++++++
++++++++++++++++++++
++++++++           +
++++++++     0     +
+++++++     ++     +
+++         ++++   +
++++        ++++   +
+++++++    +++++   +
+++++++++  +++++   +
+++++ +++++++++    +
+++++  ++++++++    +
+++++ A         +  +
++++++          +  +
+++++++++++++++++  +
+++++++++++++++    +
+++++++++++++  a   +
++++++++++++++    ++
+++++++++++++++  +++
++++++++++++++++++++
++++++++++++++++++++
