++++++++++++++++++++
++++++++++++++++++++
+++++++  +++++++++++
+++++++     +++++  +
+++++++            +
++++   0  ++       +
++++      +++++++  +
++++  +   +++++++  +
++++  +   +++++++  +
++++  +   +++  +   +
++   ++   ++++ a   +
+++  ++ A +++++    +
+++++++   +++++++  +
+++++++   +++++++  +
++++++++  +++++++  +
++++++++  +++++++  +
++++++++  +++++++  +
++++++++  +++++++  +
+++++++++++++++++ ++
++++++++++++++++++++
