++++++++++++++++++++
++++++++++++++++++++
++++               +
+++++         a    +
+++++  ++       +  +
+++++  ++   ++++++++
+++    +    ++++  ++
+++    +   +++++   +
++         +++++   +
++  +      +++++   +
+++ +      ++++++  +
+++++  +  A++++++  +
+++++0 +  +++++++  +
+++++  ++ +++++++  +
+++++  ++++++++++  +
+++++  ++++++++++  +
++++  ++++++++++++++
+++++ ++++++++++++++
++++++++++++++++++++
++++++++++++++++++++
