++++++++++++++++++++
++++++++++++++++++++
+++++++         ++++
+++++++         ++++
++++++    +     ++++
+++++    +++    ++++
+++++    +++   A++++
+++  a   +++    ++++
++++     +++    ++++
+++++    +++++    ++
++++  +  ++++++0   +
++++  +  ++++++++  +
++++     ++++++++  +
++++          +++  +
++++  +       +++  +
++++  +       ++++++
++++  ++      ++++++
++++  ++++++  ++++++
++++++++++++++++++++
++++++++++++++++++++
