++++++++++++++++++++
++++++++++++++++++++
++  +++  ++   +++  +
++                 +
+++                +
+++++++  ++   A    +
++++     ++   ++   +
+++++    ++   +++  +
++++++   ++    ++  +
+++++++  +++   ++  +
+++++++  +++++a +  +
+++++++  +++++  +  +
+++++++  +++++  +  +
+++++++ 0 ++++  +  +
+++++++   ++++  +  +
++++++++  +++++++  +
++++++++  +++++++  +
++++++++      +++  +
+++++++++    ++++ ++
++++++++++++++++++++
