++++++++++++++++++++
++++++++++++++++++++
++++++++  ++++++   +
++++++++  ++++     +
+++++++            +
++++++++       A   +
++++++   a++++++   +
++++      ++++++   +
++++     +++++++   +
++++     ++++++++  +
++++   0+++++++++  +
++++    ++++++++   +
++++    +++++++++  +
++++    +++++++++  +
+++++   +++++++++  +
++++++  +++++++++  +
++++++++++++++++++++
++++++++++++++++++++
++++++++++++++++++++
++++++++++++++++++++
