++++++++++++++++++++
++++++++++++++++++++
+++++  +++++++     +
+++++  ++++        +
+++++  +++++    +  +
+++++  +++++   +   +
+++++  +++         +
+++++  +++         +
+++++   ++  +++++  +
+++++       ++     +
+++++       +++    +
+++++   0+  +++    +
+++++  +++  +++    +
+++++  +++  +++    +
+++++  +++  +++    +
+++++   ++  +++ a  +
+++++   ++A +++    +
++++++  ++  +++    +
++++++++++++++++  ++
++++++++++++++++++++
