++++++++++++++++++++
++++++++++++++++++++
+++     A       +  +
++++               +
++++++  +  a ++    +
+++++++++   0      +
+++++++++          +
+++++++++    +++   +
+++++++++    ++++  +
+++++++++++  ++++  +
+++++++++++  +++   +
+++++++++++        +
++++++++++++       +
+++++++++++++++++  +
+++++++++++++++++  +
+++++++++++++++++  +
+++++++++++++++++  +
+++++++++++++++++  +
++++++++++++++++++++
++++++++++++++++++++
