++++++++++++++++++++
++++++++++++++++++++
++++++++++++       +
+++++++++++        +
+++++++++++  ++++  +
+++++++++    ++++  +
+++++++++    ++++  +
++++      0++      +
++++               +
+++    +           +
+++    +      +++  +
+++    +  + +++++  +
+++  a    +++++++  +
++++ ++   +++++++  +
++++++++A ++++  +  +
++++++++  ++++     +
++++++++     +     +
++++++++     ++++  +
++++++++++++++++++++
++++++++++++++++++++
