++++++++++++++++++++
++++++++++++++++++++
+++++++++++    ++  +
+++++++++++    ++  +
+++++++  +     ++  +
+++++     +    ++  +
+++++     +     +  +
+++++  +  +     +  +
+++    +  +     +  +
++++   +        +  +
++++++    0        +
++++++a            +
++++++  ++  +++++  +
++      ++  + +++  +
+++     ++         +
+++++++++++ A      +
++++++++++++++     +
+++++++++++++++   ++
++++++++++++++++  ++
++++++++++++++++++++
