++++++++++++++++++++
++++++++++++++++++++
+++++++++++  +  +  +
+++++++++++        +
++++++++     0     +
+++++++++   ++++   +
++++ +++++++++++   +
++++  +       +++  +
++++  +         +  +
++++  +  ++++      +
++++  +  ++++    +++
++++     ++++    +++
++++     ++++      +
++++A      ++      +
+++++      +++     +
+++++      ++++    +
++++++a    ++++    +
+++++++++          +
++++++++++        ++
++++++++++++++++++++
