++++++++++++++++++++
++++++++++++++++++++
++++++++++++       +
+++++++  +++       +
+++++++ 0 ++  +    +
+++++++       +    +
+++++++a       A+  +
+++++++  +++++  +  +
+++++++  +++++++   +
++++++  ++++++++   +
++++++  ++++++++   +
+++++  +++++++++   +
+++++  +++++++++   +
++++++++++++++++   +
++++++++++++++++   +
++++++++++++++++   +
++++++++++++++++   +
++++++++++++++++   +
+++++++++++++++++ ++
++++++++++++++++++++
