++++++++++++++++++++
++++++++++++++++++++
+++++++++++++++++  +
++++ ++++  +++     +
++++  +++   ++     +
++++A +++   ++     +
++++a +            +
++++  +            +
++++        0      +
++++              ++
+++++  +       +   +
++++      +    ++  +
++++      + +++++  +
+++++++++++++++++  +
+++++++++++++++++  +
++++++++++  +++++  +
+++++++++++  ++++  +
+++++++++++       ++
++++++++++++      ++
++++++++++++++++++++
