++++++++++++++++++++
++++++++++++++++++++
++++++++++      ++++
++++++++++       +++
+++++++++  +       +
+++++++++  +       +
+++++++       A    +
++++++++           +
++++++++++         +
+++++++++++++      +
+++++++  ++++      +
+++++++  ++++      +
+++++++  ++++      +
+++++++  +      a  +
++++  +  +         +
+++++          ++  +
+++++     0    ++  +
++++++       ++++  +
++++++++ ++++++++ ++
++++++++++++++++++++
