++++++++++++++++++++
++++++++++++++++++++
++++++++++++++++++++
++++++++++++++++++++
+++++++++++++   ++++
+++++++++++  0  ++++
+++++++++++     ++++
++ ++++++       ++++
++  +++         ++++
++  ++++        ++++
++              ++++
++             A +++
++  ++   +        ++
++       +        ++
+++      +         +
+++++++           ++
+++++++   a       ++
++++++++         +++
++++++++++++++ +++++
++++++++++++++++++++
