++++++++++++++++++++
++++++++++++++++++++
+++++++++++  +++  ++
++++++       +++a ++
+++++++      ++   ++
+++++++++ +  ++   ++
+++++++++    ++    +
+++++++++     A    +
+++++++++          +
+++++++++      ++  +
++++++++++     ++  +
++++++++++   ++    +
++++++++++  +      +
+++++++++          +
+++++++++          +
+++   0++   +      +
++++    +          +
++++++     ++      +
+++++++    ++++ + ++
++++++++++++++++++++
