++++++++++++++++++++
++++++++++++++++++++
++++++        +++  +
+++++        a ++  +
+++                +
++++      + A      +
++++++++     +++   +
++++++++     +++   +
++++++++++         +
++++++++++         +
++++++++++ +      ++
++++++++++++    ++++
++++++++++++    ++++
+++++++++++     ++++
+++++++++++0  ++++++
+++++++++++   +++  +
++++++++++++  +++  +
++++++++++++       +
+++++++++++++     ++
++++++++++++++++++++
