++++++++++++++++++++
++++++++++++++++++++
+++++         +++  +
+++++         +    +
+++++  +++    ++   +
+++++  +++ A  +++  +
++++++++++    +++  +
++++++++++    +++  +
++++++++++    +++  +
++++++++++     ++  +
++++++++++   a +   +
+++++++++++    ++  +
++++++  ++++   ++  +
++++++  ++++   ++  +
++++++   +++   ++  +
++++++   +     ++  +
+++++++   0 +  ++  +
++++++++           +
+++++++++++       ++
++++++++++++++++++++
