++++++++++++++++++++
++++++++++++++++++++
+++++             ++
+++++            +++
++++            ++++
++++       0   +++++
+++   +  ++ A  +++++
+++   +  ++  ++++  +
+++   ++++         +
++++  +    a       +
++++  ++     ++++  +
++++  +++++  ++++  +
++++  +++++  ++++  +
++++  +++++  ++++  +
++++  +++++  ++++  +
++++  ++  +++++++  +
++++  ++   ++++++  +
++++       ++++++  +
+++++    +++++++++++
++++++++++++++++++++
