++++++++++++++++++++
++++++++++++++++++++
++    A ++++++   +++
++       ++++++   ++
+++++++      +++   +
+++++++       ++   +
+++++++            +
+++++++   a        +
+++++++  +++       +
+++++++  ++++      +
+++++++ ++++++++  ++
++++++++++++++++   +
++++++ +++++++++   +
++++++  ++++       +
++++++  +++++      +
++++++  +++++  ++  +
++++++  0      ++  +
++++++             +
+++++++++++++     ++
++++++++++++++++++++
