++++++++++++++++++++
++++++++++++++++++++
++  ++++++++   +++++
++  +++ ++++   +++++
++      A  a0  +++++
+++           ++++++
++++++++      ++++++
++++++++++  ++++++++
++++++++++  +++++  +
++++++  ++         +
++++++  ++         +
++++++  ++         +
++++++  +          +
++ +++  +          +
++  ++  +          +
++  ++             +
++              +  +
+++       +++   +  +
+++++++++ ++++++++++
++++++++++++++++++++
