++++++++++++++++++++
++++++++++++++++++++
+++++   +++  +++++++
+++++   +++  ++++  +
+++++   +++  ++++  +
+++++   +++  ++++  +
+++++   +    ++++  +
+++++  ++    ++++  +
+++++  ++   ++     +
++          +   0  +
++       A         +
++a +  ++++     +  +
+++++  ++++++++++  +
++    +++++++++++  +
++    ++++++  +++  +
++++++++   +       +
+++++++            +
++++++++ +   ++++  +
+++++++++++  +++++++
++++++++++++++++++++
