++++++++++++++++++++
++++++++++++++++++++
++++++++  ++   ++  +
++++++++  ++   ++  +
++++++++  ++  +++  +
++++++++           +
+++++++            +
+++++++  0   ++++  +
+++++++++++++++++  +
++++++++++++++ a+  +
++++++++++++++     +
++++++++++++++     +
++++++++++++++     +
+++++++++++        +
++++++++++++ A     +
++++++++++++++     +
++++++++++++++++   +
++++++++++++++++   +
+++++++++++++++++ ++
++++++++++++++++++++
