++++++++++++++++++++
++++++++++++++++++++
+++++++++++++  +++++
+++++++++++++  +++++
+++++++        +++++
+++++++        + +++
+++++++  +  +  +   +
+++++    +         +
+++++    +    0    +
+++        +++     +
++++               +
+++++++            +
++ ++++   ++A      +
++        ++       +
+++      +++  + a  +
+++++++++     +    +
++++++++++    +    +
++++++++++++++++   +
+++++++++++++++++ ++
++++++++++++++++++++
