++++++++++++++++++++
++++++++++++++++++++
+++++++++++++++++  +
+++++++++++++++++  +
+++++++++++++++++  +
++++++++++++++++   +
+++++++++++++++++  +
++++  +++++++++++  +
++++   +++++++++   +
++++0  ++++++      +
+++++  +++++++     +
+++++   ++++++++   +
++++    ++++++++   +
++A     ++++++++   +
++      ++++++++   +
++a     +++++++++  +
++      +++++++++  +
+++     +++++++++  +
+++++++++++++++++ ++
++++++++++++++++++++
