++++++++++++++++++++
++++++++++++++++++++
++++++             +
++++++             +
++ +++  ++    ++   +
++  ++             +
++  A              +
++            ++   +
++    +       ++   +
++   ++       +    +
++   ++a +         +
++++++++++         +
++++++++++    +    +
++++++++++ +  + 0  +
++++++++++++       +
+++++++++++++      +
+++++++++++++++++  +
+++++++++++++++++  +
++++++++++++++++++++
++++++++++++++++++++
