++++++++++++++++++++
++++++++++++++++++++
++++  ++++++   +++++
++++  +++      +++++
++++  +++      ++  +
++++  +++      +   +
++++  +++          +
++++  +++  +       +
++++  +  +    +   ++
++            +    +
++  + A      a+    +
++    ++++    +    +
+++           0    +
+++             ++++
+++  +      ++++++++
+++  ++     ++++++++
+++  +++++     ++  +
++++++++++        ++
+++++++++++++++   ++
++++++++++++++++++++
