++++++++++++++++++++
++++++++++++++++++++
++++++++     a     +
++++++++           +
++++++++  ++++++   +
++++++++  +++++++  +
++++++++A++++++++  +
+++++++++++++++++  +
++  +++++++++++++  +
++  +++++++++++++  +
++    +            +
++    +0           +
++    +++++++++++  +
++    +++++++++++  +
+++    ++++++++++  +
++++    +++++++++  +
++++    ++++++    ++
++++              ++
+++++++        +++++
++++++++++++++++++++
