++++++++++++++++++++
++++++++++++++++++++
++++++++++++++++   +
+++++++   +++      +
++        +++      +
++            +    +
++  ++++      +    +
++ +++++A ++++    ++
++++++++  ++++    ++
++++++++++++++    ++
+++++   a        +++
+++++   0        +++
+++ +         ++++++
+++      +++++++++++
+++   + ++++++++++++
++++  ++++       +++
+++++  +++        ++
+++++      +++++   +
++++++     ++++++ ++
++++++++++++++++++++
