++++++++++++++++++++
++++++++++++++++++++
++++++++++         +
+++++              +
+++++         A    +
++++++++++         +
++++++++++++       +
++++++++++++++     +
+++++++++++++++a   +
+++++++++++++++    +
+++++++++++++++    +
++++++++++++++     +
++++++++++  ++     +
++++++++           +
+++++++++          +
++++++++++  0+     +
++++++++++  +++    +
+++++++++++ +++++  +
+++++++++++++++++ ++
++++++++++++++++++++
