++++++++++++++++++++
++++++++++++++++++++
+++++++++     +    +
+++++++++          +
+++++++++  +++     +
+++++++++  ++++    +
++++       ++++++  +
++++ 0     +++++   +
++++  +        ++  +
+++   +       A +  +
+++  ++   ++       +
++++ ++  +++       +
+++++++  +++  + +  +
++++++   +++ ++++  +
+++++++ +++++++++  +
+++++++++++++++++  +
++++++++++++++++a  +
++++++++++++++++   +
++++++++++++++++++++
++++++++++++++++++++
