++++++++++++++++++++
++++++++++++++++++++
+++++++++ +++      +
+++++++++  ++      +
+++++++++      ++  +
+++++++++ 0    ++  +
++++++++++     ++  +
+++++++++++        +
+++++++++++  +     +
+++++++++++ a++++  +
+++++++++++        +
+++++++++++        +
++++++++++++       +
+++++++++++++  ++  +
++++++++++++       +
+++++++++++++A     +
+++++++++++++++++  +
+++++++++++++++++  +
+++++++++++++++++ ++
++++++++++++++++++++
