++++++++++++++++++++
++++++++++++++++++++
++++++++++++++++++++
+++  A++++++++++++++
++++   a++++  +   ++
+++++   ++++  ++   +
++ ++         +++  +
++  ++        +++  +
++  ++   +++  +++  +
++  ++ 0   +  +++  +
++  ++        +++  +
++  ++  ++    +++  +
++  ++  ++    +++  +
++  +    +    +++  +
++            +++  +
++      +     +++  +
+++            ++  +
+++                +
+++++++++++++++   ++
++++++++++++++++++++
