++++++++++++++++++++
++++++++++++++++++++
++++++++++++  ++  ++
++++++++++++   +   +
+++++++++++        +
++++++  ++         +
++++++             +
++++               +
+++++        +     +
+++++    0   +++   +
+++++    +   +++   +
++  +  ++++  ++++  +
++  +  ++++  ++++  +
++ a+  ++++  ++++ ++
++ A+  ++++  +++++++
++  +  ++++  +++++++
++    ++     +++++++
++    +++   ++++++++
++++++++++  ++++++++
++++++++++++++++++++
