++++++++++++++++++++
++++++++++++++++++++
+++++   +    ++++  +
++++++        +++  +
+++++++   +   +++  +
+++++++   +        +
+++++++++++        +
+++++++++++        +
+++++++++  0       +
+++++++++   a      +
+++++++++          +
+++++++++          +
+++++++++  +++ +   +
+++++++    +++++A  +
+++++++    +++++   +
++++++   +++++++   +
+++++++  +++++++   +
+++++++++++++++++  +
++++++++++++++++++++
++++++++++++++++++++
