++++++++++++++++++++
++++++++++++++++++++
++++++++++++a0 +++++
++++++++++++    ++++
+++++++++++     ++++
+++++++++++     ++++
+++++++++++   A ++++
+++++++++++     +  +
+++++++++++        +
++++++++++++       +
++++++++++++       +
+++++++++          +
++++++++++      +  +
+++++++++   +   +  +
+++++++++       +  +
++++++++++     ++  +
++++++++++  ++ ++  +
++++++++++  +++++  +
+++++++++++++++++ ++
++++++++++++++++++++
