++++++++++++++++++++
++++++++++++++++++++
++++++++++++++++   +
++++++++++++++++   +
++++++++++++++++   +
+++++++++  ++++++  +
+++++++++  ++++++  +
+++++++++  +   ++  +
+++++++++  +    +  +
+++++++++    ++++  +
+++++++++   a++++  +
+++++++++  +++     +
+++++++++  +++     +
++      A  +++ ++  +
++         +++++   +
++0 +++++  +++++   +
++ +++++++++++++   +
++++++++++++++++   +
+++++++++++++++++ ++
++++++++++++++++++++
