++++++++++++++++++++
++++++++++++++++++++
++++++++          ++
+++++++            +
+++++++       ++   +
++++++++           +
+++++++     a     ++
+++++++  A +++++++++
+++++     ++++++++++
++++++    ++++++++++
++    +0 +++     +++
+++    +++++      ++
+++++  +++++  ++  ++
+++++  +++++  ++  ++
+++++  +++++ +++   +
+++++  +++++++     +
+++++  +++++++     +
+++++          +   +
++++++         ++ ++
++++++++++++++++++++
