++++++++++++++++++++
++++++++++++++++++++
++++++++++  +   ++++
+++  +++++  +0  ++++
+++  +++++    a    +
+++  ++            +
+++  ++       A    +
+++                +
+++                +
+++        +  +++  +
+++      +++  +++  +
+++      +++  ++   +
+++    +++++++++   +
++++   +++++++++   +
+++++  ++++++++++  +
+++++++++++++++++  +
+++++++++++++++++  +
+++++++++++++++++  +
+++++++++++++++++ ++
++++++++++++++++++++
