++++++++++++++++++++
++++++++++++++++++++
++++++++++++  +++  +
++++++++++++  +++  +
+++a +++++++  +++  +
+++   ++++++  +++  +
+++                +
+++    +           +
+++   A  ++  ++++  +
++        +  ++++  +
++           ++++  +
++                 +
++       +         +
++   +         ++  +
++  +++     +      +
+++++++ 0  +++     +
++++++++   ++++++  +
++++++++  ++++++++++
++++++++++++++++++++
++++++++++++++++++++
