++++++++++++++++++++
++++++++++++++++++++
++++++++    +++++  +
++++++++      0    +
++ ++              +
++   +     +  +++  +
+++    +   +  ++++++
+++++         ++++++
+++++         ++++++
+++++      +     +++
+++++    A +a    +++
+++++    +++++++++++
+++++ +   ++++++++++
++ +++++   +++++++++
++  ++++          ++
++  +    ++        +
++       ++++++++  +
+++                +
++++++++          ++
++++++++++++++++++++
