++++++++++++++++++++
++++++++++++++++++++
++++++++++++++++++++
++++++++++++++++++++
++++++++++++++++++++
+++++  A+++++++++  +
+++++ a     +++    +
+++++++            +
+++++++            +
+++++++0 +         +
+++++++  +         +
+++++++  +  +      +
+++++++     ++     +
+++++++  + +++  +  +
+++++++  ++  +     +
+++++++  ++  ++    +
+++++++  ++        +
+++++++  ++        +
+++++++++++++++++ ++
++++++++++++++++++++
