++++++++++++++++++++
++++++++++++++++++++
++  +++      ++++  +
++              +  +
++                 +
++  ++   ++  +    ++
++  ++   +   +    ++
++  ++  +++  +  +  +
++  ++  +++  +a +  +
++  ++ ++++  +     +
++  +++++++  ++    +
++    +++++A +++   +
++    +++++        +
+++   +++++        +
+++   +++++++++++  +
+++   +++++++++++  +
+++ 0++++++++++++  +
++++ ++++++++++++ ++
++++++++++++++++++++
++++++++++++++++++++
