++++++++++++++++++++
++++++++++++++++++++
++++++++++++++  +  +
++++++++    +     ++
+++++  +          ++
+++++  + a+     ++++
+++++  +  ++    ++++
++++              ++
++++        A      +
+++++  +  +++      +
+++++  +    +  ++ ++
+++++  +       +++++
+++++0 +       +++++
+++++       +  +++++
++++        ++++++++
+++++  +    ++++++++
+++++  +    ++++++++
++++++++    ++++++++
++++++++++++++++++++
++++++++++++++++++++
