++++++++++++++++++++
++++++++++++++++++++
+++++++++++       ++
+++++++++++        +
+++++++++++  ++++  +
+++++++++++ 0++++  +
+++++++++++  ++++  +
+++++++++++  +++   +
+++++++++++  +++   +
+++++++++++  ++    +
+++++++++++  +     +
++++++++    ++a    +
+++++++++   +++    +
++++  +++++++++    +
+++++              +
++++++             +
++++++++++++++A +  +
++++++++++++++     +
+++++++++++++++   ++
++++++++++++++++++++
