++++++++++++++++++++
++++++++++++++++++++
+++  +++   0   +++++
+++  ++         ++++
+++       ++++  ++++
+++     a ++++  ++++
+++       +++    +++
+++       +++     ++
+++       +++  +  ++
+++       +++ ++  ++
+++      +++++++   +
+++    + ++ ++++   +
+++    ++++     A  +
+++++  ++++        +
+++++   +++  +++   +
+++     ++++++++   +
+++    +++++++++   +
+++++  ++++++++++  +
++++++++++++++++++++
++++++++++++++++++++
