++++++++++++++++++++
++++++++++++++++++++
+++++++            +
+++++++            +
+++++++            +
+++++++            +
+++++++      ++    +
+++++++      +++++++
+++++++     ++++++++
+++++       ++++++++
++++++     +++++++++
+++++++  a +++++++++
+++++++    +++++++++
+++++       A 0+++++
++++++            ++
+++++++++  ++++    +
+++++++++++++++++  +
+++++++++++++++++  +
++++++++++++++++++++
++++++++++++++++++++
