++++++++++++++++++++
++++++++++++++++++++
+++++      +++++++++
+++++      ++++ ++++
+++++  ++  ++++  +++
+++++  ++  ++++  +++
++++  +++  ++++    +
++++  +++  +++     +
++    +++          +
++    ++++a        +
++    +++++  ++    +
++   +++ ++  ++    +
++   +++  +  ++    +
++   +++  ++++++   +
+++  +++  ++++++A  +
+++  +++           +
+++  +++      0    +
+++  +++  +++++++  +
+++++++++++++++++ ++
++++++++++++++++++++
