++++++++++++++++++++
++++++++++++++++++++
++++++++     ++   ++
+++++0 +     ++    +
++++        +++a   +
+++++       +++    +
+++++          A   +
++                 +
+++         ++     +
+++  +           +++
++++ +    +     ++++
++++++   ++++   ++++
++++++   ++++     ++
++++++  +++++     ++
++++ +        ++++++
++++          ++++++
++++    ++++++++++++
++++    ++++++++++++
++++++++++++++++++++
++++++++++++++++++++
