++++++++++++++++++++
++++++++++++++++++++
++++++++++++   ++  +
++++++++++++   0+  +
+++++++++++  ++    +
++ ++++++++  ++    +
++          +++    +
+++         +++    +
++++++++++++++     +
++++++++++++++     +
+++++++++++++      +
++++++++  + +     ++
++++++++  +      +++
+++++++          +++
++++++++       +++++
++++++++++  a     ++
++++++++++    A    +
+++++++++++++++++  +
+++++++++++++++++ ++
++++++++++++++++++++
