++++++++++++++++++++
++++++++++++++++++++
++      A     ++++++
++            ++++++
++  +++++     ++++++
++ +++++       +++++
+++++++          +++
+++++++      +     +
+++++++  ++       ++
+++++++ a++   0   ++
+++++++  ++   ++++++
+++++++  +++  ++++++
+++++++ +   ++++  ++
+++++++++          +
+++++++++++        +
+++++++++++++++    +
+++++++++++++++    +
+++++++++++++++    +
+++++++++++++++++ ++
++++++++++++++++++++
