++++++++++++++++++++
++++++++++++++++++++
++++++++     ++++  +
++++            A  +
+++++              +
++++++++   +  +++  +
+++++++++  +  +++  +
+++++++++  +    +  +
+++++++++  +  a +  +
+++++++++  ++   +  +
+++++++++  +++  +  +
+++++++   ++++  +  +
+++++++   ++++  0  +
+++++++  ++  ++    +
++++++   ++  ++++  +
++++++       + ++  +
+++++             ++
++++++            ++
+++++++    +++++++++
++++++++++++++++++++
