++++++++++++++++++++
++++++++++++++++++++
++++++++++++++  ++++
++++++++++++++  +  +
++++++++++++++  +  +
++++++++++++       +
++++++++++++       +
+++++++a   A       +
+++++++      0     +
+++++++  +   +  +  +
+++++++            +
++                 +
+++             +  +
++++++++           +
++ ++++++   +++   ++
++         ++++   ++
++         ++++  +++
++  +++++++++++  +++
+++ ++++++++++++++++
++++++++++++++++++++
