++++++++++++++++++++
++++++++++++++++++++
+++++++++          +
+++++++++          +
++++++++           +
++++++++0          +
+++++++++          +
+++++++++    a  A ++
+++++++++  +      ++
++++++++++++++++  ++
++++++++++++++++   +
+++  +++++++++++   +
+++  ++++++++++++  +
+++  ++++++++++++  +
+++  ++++++++++++  +
+++  ++++++++++++  +
+++      ++++++++  +
++++      +++++++  +
+++++++ +++++++++ ++
++++++++++++++++++++
