++++++++++++++++++++
++++++++++++++++++++
+++++    A+++++++  +
+++++     ++++++   +
+++++  +  ++++++   +
+++++     ++++++   +
+++++ a     ++++   +
+++++  +          ++
+++++  +          ++
+++++  +      +   ++
+++++  ++     +   ++
+++++  ++++   +   ++
+++++  +++++ 0+   ++
+++++  ++++++++   ++
+++++  +++++  +    +
+++++  +  ++  +    +
+++++ ++  ++  +    +
++++++++           +
+++++++++         ++
++++++++++++++++++++
