++++++++++++++++++++
++++++++++++++++++++
+++++++++   ++++++++
+++++++++   +++++  +
+++++++++          +
+++++++++       0  +
+++++++++  ++++++  +
+++++++++ +++++++  +
++++++  +++++      +
+++++++  ++++      +
+++++++  ++++      +
+++++++  +++++     +
++++ ++  ++        +
++++a +  ++     +  +
++++  +     ++  +  +
++++     A  ++  +  +
++++     +++++     +
++++  +            +
++++++++          ++
++++++++++++++++++++
