++++++++++++++++++++
++++++++++++++++++++
+++++  ++++++++++  +
+++++  ++++++++++  +
+++++  +   ++++++  +
+++         +++++  +
+++   +  + a++++A  +
+++  +++++  ++++   +
+++   ++++         +
+++    ++++        +
+++    ++++++++    +
+++    ++++++++    +
+++    0 ++++++    +
+++       ++++++   +
+++                +
+++  ++++          +
+++  ++++++++++++  +
+++  ++++++++++++  +
+++++++++++++++++ ++
++++++++++++++++++++
