++++++++++++++++++++
++++++++++++++++++++
+++++++++++++++++  +
+++++++++++++++++  +
++++ +++++   ++++  +
++++   +++      +  +
++++    +++        +
++++    +++++++    +
++++    +++++++    +
++++    +++++++    +
++++    ++  +++    +
++++    ++  + ++   +
+++++   ++    a +  +
+++++              +
+++++              +
+++++      A0      +
+++++       +     ++
+++++      ++++ ++++
+++++++++  +++++++++
++++++++++++++++++++
