++++++++++++++++++++
++++++++++++++++++++
+++++++++          +
+++++++++          +
+++++++++          +
+++++++++          +
+++++++++         ++
+++++++++  A  a   ++
+++++++++      0   +
+++++++++          +
+++++++++    +     +
++++++             +
++++++             +
+++++++++    +    ++
+++++++++    +  ++++
+++++++++  +++  ++++
+++++++++  +++  ++++
+++++++++  +++++++++
++++++++++++++++++++
++++++++++++++++++++
