++++++++++++++++++++
++++++++++++++++++++
+++++++++++++0+++  +
+++++++++++++      +
++++++++++++++     +
++++++++++++++     +
+++++++++ +++     ++
+++++++++  ++      +
+++++++++       +  +
+++++++++          +
+++++++++   +      +
+++++  ++  ++ a    +
++++   ++          +
+++++  +++      +  +
+++++  +++++++     +
+++++              +
++++++A            +
+++++++++++++++++  +
++++++++++++++++++++
++++++++++++++++++++
