++++++++++++++++++++
++++++++++++++++++++
++++++          ++++
++++++          ++++
++++++            ++
+++               ++
+++          0 +++++
+++    +       +++++
+++    +        ++++
+++  +++      + ++++
+++  +++ a    ++++++
+++  +++      ++++++
+++ A+++  +   ++++++
++++++++  ++   +++++
++++++++  ++     +++
++++++++++++++   +++
+++++++++++++++  +++
+++++++++++++++  +++
++++++++++++++++++++
++++++++++++++++++++
