++++++++++++++++++++
++++++++++++++++++++
++++++++++++++     +
++++++    ++++     +
+++++++    +++     +
+++++++++  +++     +
+++++++++  +++  +  +
+++++  ++       +  +
+++++  +++      +  +
+++++  ++          +
+++++  ++ 0        +
+++++ A    +++     +
+++++      +++     +
++++++++++++++     +
+++++++++  +++  +  +
+++++++++  +++  +  +
++++++      a      +
+++++++            +
++++++++++++++ ++ ++
++++++++++++++++++++
