++++++++++++++++++++
++++++++++++++++++++
++++++++++++++  ++++
++++++++++++++  ++++
+++ ++++++++++  +  +
+++  ++++++++  0   +
+++  ++++++++      +
+++  +++++++++     +
+++  +  ++++++ A   +
+++  +  +          +
+++  +             +
+++  +     ++++    +
+++  +   a         +
+++  +             +
+++  ++            +
+++  +++        + ++
++++            ++++
++++           +++++
++++++++++++++++++++
++++++++++++++++++++
