++++++++++++++++++++
++++++++++++++++++++
++++++      +  +++++
++++++      +  ++  +
++++++         ++  +
++++++  0       +  +
+++++       ++     +
+++++       +++    +
+++++   +   A++    +
+++++   +    ++++  +
+++++   +    +++++++
++++    +   ++++++++
++++    +   ++++++++
++++    ++  ++++++++
++++        ++++++++
++++        a     ++
++++               +
++++    +++++++++  +
++++++++++++++++++++
++++++++++++++++++++
