++++++++++++++++++++
++++++++++++++++++++
++++++++  ++       +
++++               +
+++++              +
+++++         A    +
+++++  +++++   +   +
+++++  ++++++  +   +
+++++  ++++++  +   +
+++++  ++++   a+   +
+++++ 0++++    ++  +
+++++  ++++    ++  +
++++++++++++  +++  +
+++++++++++++ ++++++
++++++++++++++++++++
++++++++++++++++++++
++++++++++++++++++++
++++++++++++++++++++
++++++++++++++++++++
++++++++++++++++++++
