++++++++++++++++++++
++++++++++++++++++++
+++++++++++  0     +
+++++++++++        +
+++++++++++  ++++  +
+++++++++++  ++ a  +
+++++++++++ A+++   +
+++++++++++  +++   +
+++++++++++  ++++  +
+++++++++++  ++++  +
+++++++++++    ++  +
+++++++++++        +
+++++++++++        +
+++++++++++ +   +  +
+++++++++++++  ++  +
+++++++++++++      +
+++++++++++++      +
+++++++++++++  ++  +
++++++++++++++++++++
++++++++++++++++++++
