++++++++++++++++++++
++++++++++++++++++++
++++++++++  +++   ++
+++    +++  +++   ++
++++    ++  +++   ++
++++++  +  +      ++
+++  +            ++
+++  +        +   ++
+++  +            ++
+++aA+          +  +
+++  +        +++  +
+++  +        +++  +
+++  +  ++++  +++  +
+++     ++++  +++  +
+++ 0   ++    +++  +
++++    +++   +++  +
++++++++++++  +++  +
++++++++++++       +
+++++++++++++     ++
++++++++++++++++++++
