++++++++++++++++++++
++++++++++++++++++++
++       0    ++   +
++                 +
++                 +
++  +++++++        +
++  +++++++  +     +
++ ++++++++ A+a    +
++++++++++++++     +
++++++++++++++++   +
+++++++++++++ +    +
+++++++++++++      +
++++++++++++++     +
++++++++++++++++   +
+++++++++++++++++ ++
++++++++++++++++++++
++++++++++++++++++++
++++++++++++++++++++
++++++++++++++++++++
++++++++++++++++++++
