++++++++++++++++++++
++++++++++++++++++++
++++      +++++++  +
++++       ++++++  +
++++  +++  ++++++  +
++++ ++++   +++++  +
+++++++++    ++++  +
+++++++++    ++++  +
+++++++++   0++++  +
+++++++++          +
++++++ ++++       ++
++++++       ++  +++
++++++           +++
+++++        A   +++
+++++            +++
+++++   a   +     ++
++++++      +      +
++++++             +
+++++++  ++     + ++
++++++++++++++++++++
