++++++++++++++++++++
++++++++++++++++++++
++++++  +++++++++  +
++++++     ++++++  +
++++++      +++++  +
++++++  ++  +++++  +
++++++  ++   ++++  +
+++ ++   +   ++++  +
+++    +     ++++  +
++++   +      +++  +
++++++        +    +
++++++        +    +
++++++  +++        +
++++++0A+++     a  +
++++++  +++        +
++++++ ++++    +   +
+++++++++++    +   +
+++++++++++        +
++++++++++++      ++
++++++++++++++++++++
