++++++++++++++++++++
++++++++++++++++++++
+++++++++++++      +
+++++++++++++      +
+++++++++++++   +  +
++++++++++++++  +  +
++++++++++++++  +  +
++++++++++++++  +  +
++++++ +++++++  +  +
++++++  ++++++ a+  +
++++++  ++++++ A  ++
++++++  +          +
++++++   +      +  +
+++++++   ++++++0  +
++++++++  ++++++   +
++++++++  ++++++   +
++++++++           +
++++++++           +
++++++++++++++++++++
++++++++++++++++++++
