++++++++++++++++++++
++++++++++++++++++++
+++++++    +++  ++++
+++++++    +++  ++++
+++++ +         ++++
+++++   ++      ++++
++++++  ++++++  +  +
++++++++++++++a +  +
++++++++++++++  +  +
+++++++++++        +
++++  +++++       ++
++++  +++++  ++  +++
++++  +++++A ++    +
++++         +++   +
+++      0   +++   +
+++       ++++++   +
+++         +++++  +
+++     +          +
++++ +  ++ +      ++
++++++++++++++++++++
