++++++++++++++++++++
++++++++++++++++++++
++++++     ++++++  +
++++++     ++++++  +
++++    +       +  +
++++    +      A   +
++     ++  +++++   +
++    a+++++++++   +
++       +++++++   +
++    +         0+++
++    +++        +++
++    +++++++++++  +
++ +       ++++++  +
++++           ++  +
++++     ++     +  +
++ +     +++++  +  +
++    +  +++++     +
++      +++++++    +
+++     +++++++++ ++
++++++++++++++++++++
