++++++++++++++++++++
++++++++++++++++++++
++++++++++       +++
++++++++++        ++
++++++++++ +++++  ++
++++++++   0++++  ++
++++++      +++++  +
++  ++   +  +++++  +
+++  +++++   ++++  +
+++    ++++A   ++  +
+++    ++++    +++++
++     ++++    +++++
++     ++++    +++++
++      ++    ++++++
++   a   +       +++
++       +  +     ++
++                ++
++++              ++
++++++   +++++++  ++
++++++++++++++++++++
