++++++++++++++++++++
++++++++++++++++++++
++++  +++++  ++   ++
++++   ++++  ++   ++
++++  A       +   ++
++++              ++
++    +++        +++
++    +++     +    +
++    +++ ++  +++  +
++   +++++++       +
++  ++++++++       +
++  ++++++++    +  +
++  ++++++++a   +  +
++  +++++0      +  +
++  ++++++         +
++  ++++++++  +    +
++  ++++++++++++   +
++   +++++++++++   +
+++ +++++++++++++ ++
++++++++++++++++++++
