++++++++++++++++++++
++++++++++++++++++++
+++++++++++        +
++++++++++         +
+++         +  ++  +
+++  A         ++  +
+++  +++++++   ++  +
++++++++++++   ++  +
++++++++++++  a+   +
++++++++++++   ++  +
+++++++++  +   ++  +
+++++++++          +
+++++++++          +
+++++++++    +     +
+++++++++    +     +
+++++++++  0 +    ++
++++++++++  ++   +++
++++++++++++++  ++++
++++++++++++++++++++
++++++++++++++++++++
