++++++++++++++++++++
++++++++++++++++++++
++++++++++++  +++  +
++++++++++++  +++  +
+++++++++++   +++  +
++++     a         +
++                 +
+++  ++   +   ++++++
++++++    +   ++++++
++++++    +   ++++++
++++0A       +++++++
+++++     +  +++++++
+++++++        +++++
+++++++        +++++
+++             ++++
++++             +++
++++++++         +++
+++++++++        +++
++++++++++     + +++
++++++++++++++++++++
