++++++++++++++++++++
++++++++++++++++++++
++A          +++++++
+++               ++
+++  ++            +
+++  ++      ++++  +
+++++++      +  +  +
+++++++      +a +  +
+++++       ++  +  +
+++++      +++0 +  +
+++++       ++  ++++
+++++       ++  ++++
+++    +    ++  ++++
+++    +++  ++  ++++
+++  +++++  ++  ++++
+++ ++++++  ++  ++++
++++++++++  ++  ++++
++++++++++     +++++
+++++++++++    +++++
++++++++++++++++++++
