++++++++++++++++++++
++++++++++++++++++++
++++++++++++     +++
++++++++++        ++
+++++++  ++    +  ++
+++++++  ++        +
+++++++ 0++        +
+++++++      +++   +
+++++++      ++++  +
+++++++      ++++  +
+++++  a ++  +     +
+++      ++A +     +
+++      ++  +     +
++++               +
+++++      +       +
++++++     +++    ++
+++++++++  +++    ++
+++++++++      +++++
++++++++++     +++++
++++++++++++++++++++
