++++++++++++++++++++
++++++++++++++++++++
+++++++++++++++++  +
+++++++++++++++++  +
+++++++++++0  +++  +
++++++++++++  +++  +
++++++++++++  +++  +
++ +++++++++    +  +
++      +  +    +  +
+++        ++      +
+++++++            +
+++ ++             +
+++  +     ++      +
+++  +  +  ++      +
+++  +  +  ++      +
+++A + a           +
+++  +        +    +
+++           +    +
++++    ++  +++++ ++
++++++++++++++++++++
