++++++++++++++++++++
++++++++++++++++++++
++++++++        0  +
++++++++           +
++++++++    ++     +
++++++++    +++++  +
++++++++    +++++  +
++++++++    ++++++++
+++++  +a    +++++++
+++++  ++     ++++++
+++    +++++  ++++++
+++    +++++    ++++
++     +++++    ++++
++     ++++++   ++++
++       ++++   +  +
++ +         A  +  +
++++              ++
++++     ++  ++   ++
+++++   ++++++++++++
++++++++++++++++++++
