++++++++++++++++++++
++++++++++++++++++++
+++++++++++++  +   +
++++++++++         +
+++++++++++        +
+++++++++++++++++  +
+++++++++++++++++  +
++++++  +++++++++  +
++++++  ++++  +++  +
++++++  ++++  +++  +
++++++  ++++       +
++++++  ++++      ++
++++++  +++  +  + ++
++++++   ++ a A ++++
+++++++   +     +  +
++++++++  +    0   +
++++++++  +        +
++++++++    +      +
+++++++++   +++   ++
++++++++++++++++++++
