++++++++++++++++++++
++++++++++++++++++++
++++++++++++       +
++++++++++++       +
++++++++++++    A  +
++++++++++++       +
++++++++++++       +
++++++++++      a  +
+++++++++++     +  +
++++++++++++  0++  +
+++++++++++++++++  +
+++++++ ++++  ++   +
+++++++    +   +   +
++++++++           +
++++++++++   +     +
++++++++++   ++++  +
++++++++++  +++++  +
++++++++++  +++++  +
++++++++++++++++++++
++++++++++++++++++++
