++++++++++++++++++++
++++++++++++++++++++
+++++++++ 0    +   +
++++++++     A +   +
++++++++      +++  +
++++++ +           +
++++++             +
+++++++ a          +
++++++++       +   +
+++++++++++   +++  +
+++++++++++  ++++  +
+++++++++++++++++  +
+++++++++++++++++  +
++++++++++++++++++++
++++++++++++++++++++
++++++++++++++++++++
++++++++++++++++++++
++++++++++++++++++++
++++++++++++++++++++
++++++++++++++++++++
