++++++++++++++++++++
++++++++++++++++++++
+++++++++          +
+++++++++          +
+++++++++ +++++++  +
+++++++++++++++++  +
++++  +++++++++++  +
++++  +++++++++++  +
++++  +++++++++++  +
++++  ++++++++++++++
++++    ++++++++++++
++++    +++0 A +++++
++++    +++    +++++
++++    +++  ++++  +
++      +++  ++ +  +
+++      ++  ++    +
++++      + a+++   +
++++            +  +
+++++          ++ ++
++++++++++++++++++++
