++++++++++++++++++++
++++++++++++++++++++
++++++++       ++  +
++++++++  a        +
++++++++   +++     +
++++++++A +++++++  +
++++++++ ++++ +++  +
+++++++++++++  ++  +
+++++++++++++      +
++++++++++++++     +
+++++++++++++++    +
+++++++++++++++    +
++++++++++++++0    +
+++++++++++++++    +
+++++++++++++++    +
+++++++++++++++    +
+++++++++++++++    +
++++++++++++++++   +
+++++++++++++++++ ++
++++++++++++++++++++
