++++++++++++++++++++
++++++++++++++++++++
+++++++++++++++    +
++++++++++++++++   +
++++++++++++++ +   +
++++++++++++++     +
++++++++++++++     +
++++++++++++++     +
++++++++++++  A    +
+++++++++++++      +
++++++++  +     a  +
++++++++  +        +
++++++++  +  ++++  +
+++   ++    +++++  +
+++    ++   ++++++++
+++++         0 ++++
+++++           ++++
+++++   +++   ++++++
++++++ +++++++++++++
++++++++++++++++++++
