++++++++++++++++++++
++++++++++++++++++++
++++++  ++++  a    +
++++++  ++++       +
++ +++  +  +  ++   +
++  ++  +     ++   +
++      ++    +    +
+++  A  ++++  +    +
++++    ++++++++   +
+++  +        ++   +
+++  +             +
+++  +  ++         +
+++  +        ++   +
+++0 ++      +++   +
++  ++++++++++++   +
+++ ++++++++++++   +
++++++++++++++++   +
+++++++++++++++++  +
++++++++++++++++++++
++++++++++++++++++++
