++++++++++++++++++++
++++++++++++++++++++
+++++++++++++++++  +
+++++++++++++++++  +
+++++++++++ Aa     +
+++++++++          +
+++++++++       ++++
+++++++++    +  ++++
+++++++++    +   +++
+++++++++    +     +
++++ ++++    +     +
++++  +            +
++++               +
++++       0       +
+++++      +       +
+++++++   ++       +
++++++++  ++   +   +
++++++++++++       +
+++++++++++++     ++
++++++++++++++++++++
