++++++++++++++++++++
++++++++++++++++++++
+++++++++++++  ++  +
+++++++++++        +
+++++++++++        +
++++  ++++         +
++++     a         +
++++A       0     ++
++++              ++
+++  +             +
++++ +     +   ++  +
++++++  +++++  ++  +
+++++++ +++++  ++  +
++++++++++++++  +  +
++++++++++++++  +  +
++++++++++++++  +  +
++++++++++++++  +  +
++++++++++++++    ++
+++++++++++++++   ++
++++++++++++++++++++
