++++++++++++++++++++
++++++++++++++++++++
+++++++++++++++++  +
++++++++++++++++0  +
++++++++++++++++   +
++  ++++++++++     +
++  +++++++++  a   +
++    ++++++++     +
++     +  ++++     +
+++++  +           +
+++++              +
++++++        A    +
++++++++   +++  +  +
++++++++   +++  +  +
++++++++   +++  +  +
++++++++   +++ ++  +
++++++++   +++++++++
++++++++   +++++++++
+++++++++ ++++++++++
++++++++++++++++++++
