++++++++++++++++++++
++++++++++++++++++++
++++++++++++++++++++
++++++    ++++++++++
++++++     +++++  ++
++++++     +++++   +
+++++++++0 ++      +
+++++++    ++      +
+++++++a    +  +   +
+++++++            +
+++++++         A  +
++++++++    +      +
++++++++++         +
++++++++++         +
++++++++           +
+++++++++          +
++++++++++         +
++++++++++++++++++++
++++++++++++++++++++
++++++++++++++++++++
