++++++++++++++++++++
++++++++++++++++++++
++++++++    ++++++++
++++++++     ++  +++
++++++++  +  ++  +++
+++++a++  +  ++    +
+++++  +  +  ++    +
+++++    ++        +
++++++    +        +
+++++++   ++++     +
+++++++  A         +
++++           ++  +
++++           ++  +
++++  ++   +++     +
++++ 0++  +++++    +
++++  ++  ++++++   +
++++  ++++++++++  ++
++++++++++++++++   +
+++++++++++++++++ ++
++++++++++++++++++++
