++++++++++++++++++++
++++++++++++++++++++
++++++++++++++  +  +
++++++++++++++     +
++++++++++++0      +
++++++++++++    A  +
++++++++++++       +
+++++++++++++      +
++++++++++      +  +
+++++++++++    ++  +
+++++++++++++  ++  +
+++++++++++++++    +
+++++++++++++++    +
++++++++        +  +
++++++      a   +  +
++++++    ++++++   +
+++       +++++++  +
++++      +++++++  +
+++++++  +++++++++++
++++++++++++++++++++
