++++++++++++++++++++
++++++++++++++++++++
++++++++++  ++++  ++
+++++++  +   +++  ++
+++++++          +++
+++  ++          +++
+++   +  +   +++++++
+++      +   +  ++++
+++             ++++
++++            +  +
++++++   +        ++
++++++   +     +  ++
++      0          +
+++          A     +
++++++  ++  +++++  +
++++++  ++  +++++  +
++++++    a +++++  +
+++++++     +++++ ++
++++++++++++++++++++
++++++++++++++++++++
