++++++++++++++++++++
++++++++++++++++++++
++++               +
++++               +
++++     +         +
++++     ++    a  ++
++++    +++++  +++++
++++ +  +++++  +++++
++++   ++++++  +++++
++++A0 ++++++  +++++
+++++++++++++  +++++
+++++++++++++  +++++
+++++++++++++  +++++
++++++++++    ++++++
++++++++++    ++++++
++++++++++   +++++++
+++++++++++  +++++++
++++++++++++++++++++
++++++++++++++++++++
++++++++++++++++++++
