++++++++++++++++++++
++++++++++++++++++++
++++++++         +++
+++    +         +++
++++               +
++ +++             +
++  +      +       +
++        ++++     +
++        +++++    +
++++++  0++++++  +++
+++++++++++++++A +++
+++++++++++++++  +++
+++++++++++++++  +++
+++++++++++++++  +++
++++++++++++    a  +
++++++++++++       +
++++++++++++       +
++++++++++++  +    +
+++++++++++++ ++  ++
++++++++++++++++++++
