++++++++++++++++++++
++++++++++++++++++++
+++++++++++++++   ++
++++++++ ++++++    +
++++++++  ++       +
+++++  +  +++      +
++++++    ++++++   +
++++++    ++++++   +
++++++             +
++++++             +
+++++++         +  +
+++++     +    0   +
+++++A    +   +    +
+++++   +++  a+    +
+++++   ++    +    +
+++++              +
+++++      ++      +
+++++  ++++++++    +
++++++++++++++++++++
++++++++++++++++++++
