++++++++++++++++++++
++++++++++++++++++++
++++           +++++
++++           +++++
++++a ++++  +   ++++
++++  ++++  ++++++++
++++  ++++  ++++++++
++++ A++++  ++++++++
++++    0   ++++++++
+++         ++++++++
+++         +++++  +
++++        +++++  +
+++++   +  ++++++  +
+++++ +++  ++++++  +
+++++++++      ++  +
+++++++++      ++  +
+++++++++++ +   +  +
+++++++++++++      +
++++++++++++++    ++
++++++++++++++++++++
