++++++++++++++++++++
++++++++++++++++++++
++++  ++++++++++++++
++++  ++++++++++++++
++++  ++++++++++++++
++++  ++++++++++++++
++++  ++++++++++++++
++++  ++++++++++++++
++++  ++++++  +++  +
++++ +        +++  +
++++++             +
++++++    +        +
++++ +    +    ++  +
++++      +        +
++++  a   +        +
++++   +  +     +  +
++++ A +  + 0   +  +
++++  ++        +  +
+++++++++      +++++
++++++++++++++++++++
