++++++++++++++++++++
++++++++++++++++++++
+++++++++++++  +++++
+++++ +++++++  +++++
+++++  ++++++  ++  +
+++++     +++A     +
+++++              +
+++++  ++      +   +
++a          +++   +
++                 +
++++++  0          +
+++++++++          +
+++++++++          +
++++++++++++++++   +
++++++++++++++++   +
++++++++++++++++   +
+++++++++++++++ +  +
+++++++++++++++    +
++++++++++++++++  ++
++++++++++++++++++++
