++++++++++++++++++++
++++++++++++++++++++
+++++++++     +++  +
+++++++++    ++++  +
++++++++   ++      +
++++++++           +
+++++++   0    ++  +
++++++      +      +
++                 +
++                 +
++  ++     A   ++ ++
++ ++++  ++++  ++  +
+++++++  ++++  ++  +
+++++++  ++++a    ++
+++++++  +++++    ++
+++++++  +++++++++++
+++++++ ++++++++++++
++++++++++++++++++++
++++++++++++++++++++
++++++++++++++++++++
