++++++++++++++++++++
++++++++++++++++++++
+++++++  +  ++     +
+++ 0    +   +     +
++++  A  +         +
++  a      +       +
++         +++     +
++  +++   ++++  +  +
+++++++         +  +
++++++++           +
++++++++++++       +
++++++++++++   ++  +
+++++++++++++     ++
++++++++++++++++  ++
++++++++++++++++++++
++++++++++++++++++++
++++++++++++++++++++
++++++++++++++++++++
++++++++++++++++++++
++++++++++++++++++++
