++++++++++++++++++++
++++++++++++++++++++
+++++      0  +  +++
+++++           ++++
++++++  ++       +++
+++++++++++       ++
++++++  ++++++     +
++++++  ++++++    ++
++++++  ++++++     +
+++++++  +     +   +
+++++++        +   +
+++++++     ++++   +
+++++++  ++++++++  +
+++  ++  ++++++++  +
++++  +++++++++++  +
++++    +++++ +++  +
++++   a+++++  A   +
++++               +
+++++             ++
++++++++++++++++++++
