++++++++++++++++++++
++++++++++++++++++++
+++++              +
+++++             ++
++++++++++  ++  ++++
+++++++++   ++   +++
++++++++    ++    ++
++++++    a +++   ++
+++++++            +
++++               +
++++         +++A  +
++++              ++
++++  +     0      +
++++ ++++++        +
++++++++++++       +
+++++++++++++++    +
+++++++++++++++    +
+++++++++++++++    +
++++++++++++++++  ++
++++++++++++++++++++
