++++++++++++++++++++
++++++++++++++++++++
+++++++  +++++++++++
+++++++  +++++++++++
+++++++  +++++++++++
+++++++  +++++++++++
+++++    +++++++++++
+++++    +++++++++++
+++++      +++  ++++
+++++A      ++  ++++
++++     +  ++   +++
++++     +       +++
++++     +      ++++
++++     +      ++++
+++++       a+  ++++
+++++        +  ++++
+++++    +     0++++
+++++             ++
+++++++++         ++
++++++++++++++++++++
