++++++++++++++++++++
++++++++++++++++++++
++++++++++         +
+++++++       A   ++
++++++++    +  +++++
++++++++++  ++++++++
++++++++++   ++++  +
++++++++++         +
++++++++++         +
++ ++       a +++  +
++  +       ++     +
++  +  ++       0  +
++     ++          +
+++    +++  +   +  +
++++++++++  ++  +  +
++++++++++  +++++  +
++++++++++    +++  +
+++++++++++        +
++++++++++++++    ++
++++++++++++++++++++
