++++++++++++++++++++
++++++++++++++++++++
++  0     A  +++   +
++       a     +   +
++ +  ++++         +
++++  +++++        +
++++  +++++++      +
+++++++++++++      +
+++++++++++++++++  +
++++++++++++++++   +
++++++++++++++++   +
+++++++++++++      +
++++++++++++++     +
++++++++++ +++++   +
++++++++++   +++  ++
++++++++++        ++
++++++++++++      ++
++++++++++++  +   ++
++++++++++++++++ +++
++++++++++++++++++++
