++++++++++++++++++++
++++++++++++++++++++
++    +++  +++++++++
++     ++   ++++++++
++ ++  ++   ++++++++
+++++  ++   +  +++++
+++++  ++A  +   ++++
++++++  +       ++++
++++++  +++a    ++++
++++++  +++  +    ++
++++++  +++  ++    +
++++++          +  +
+++++++            +
++++++++  +        +
++++++++  +        +
++++++++    0      +
+++++++++          +
+++++++++   +    +++
++++++++++  ++++++++
++++++++++++++++++++
