++++++++++++++++++++
++++++++++++++++++++
+++++++++++++++++  +
+++++++++++++++++  +
+++++++++++++  ++  +
++++ +++ +         +
++++               +
+++++           +  +
+++++  +   +++  +  +
+++++  +a ++++  +  +
+++++    +++++  +  +
+++++    ++  +  + ++
++++++   ++  +  ++++
+++++    ++  +  ++++
+++++          +++++
++++++      A   +  +
++++++++   0       +
+++++++++++        +
++++++++++++      ++
++++++++++++++++++++
