++++++++++++++++++++
++++++++++++++++++++
+++++++++  +++++   +
++++++++++  ++++   +
++     +++  ++++   +
++      +          +
++  ++             +
++ +++      A+++   +
+++++++      +++   +
++++++++     ++    +
++++++++     ++    +
++++++++          ++
++++++++          ++
++++++++  +       ++
++++++++ +++       +
++++++++++++a+     +
++++++++++   0     +
+++++++++++        +
++++++++++++++++  ++
++++++++++++++++++++
