++++++++++++++++++++
++++++++++++++++++++
+++++++       ++  ++
++                ++
++         +      ++
++         +  ++  ++
++            ++++++
++  ++        ++++++
+++ ++        + ++++
++++++  0     +  +++
++++++        +  +++
++++++     +  +  +++
++++++    ++  +  +++
++++++A   ++  +  +++
++++++  +++++++  +++
++++++  +++++++  +++
++++++a++++++++   ++
+++++++++++++++    +
++++++++++++++++  ++
++++++++++++++++++++
