++++++++++++++++++++
++++++++++++++++++++
++++++++  ++       +
++++++++   +  0    +
+++   ++   ++++++  +
++++   +   ++++++  +
++++       ++++++  +
++++       ++++++  +
++++  +       A++  +
+++++++        ++  +
+++++   +  ++  ++  +
+++++ a +  ++  ++  +
+++++  +        +  +
++++++          +  +
+++                +
++++               +
++++++    +++      +
++++++    +++  ++  +
+++++++ ++++++ ++ ++
++++++++++++++++++++
