++++++++++++++++++++
++++++++++++++++++++
++++++       ++++  +
++++++      +++++  +
++++++       ++++  +
++++++        +++  +
++++++   +++  +++  +
++++++0 +++   +++  +
++++    +++   +++  +
+++     +++        +
++++A  ++++        +
++++a   +++++      +
+++++    ++++      +
+++++++  ++++      +
+++++++  ++++      +
++++++++  +++      +
++++++++           +
++++++++          ++
+++++++++ +++++++ ++
++++++++++++++++++++
