++++++++++++++++++++
++++++++++++++++++++
++++  +++  +++++++++
++++0 +++   ++++++++
++++  +++     +  +++
++++  +++          +
++++  +++  a       +
++++  +++     +    +
++++   ++          +
+++++  +++    +    +
+++++  +++    +    +
++++   ++          +
++++              ++
+++++       +++A +++
++++++      ++++ +++
++++++++++  ++++++++
++++++++++  ++++++++
++++++++++   +++++++
+++++++++++ ++++++++
++++++++++++++++++++
