++++++++++++++++++++
++++++++++++++++++++
++++++++0 +++  ++  +
++++++++  +  A ++  +
++++++++  +    ++  +
++++++++  +        +
++++++++           +
+++++++++   +      +
++++++++++  +      +
+++++++++++++      +
+++++++++++        +
+++++++++++        +
+++++++++++  a     +
++++++++++++       +
++++++++          ++
+++++++++         ++
++++++++++         +
++++++++++         +
+++++++++++    ++ ++
++++++++++++++++++++
