++++++++++++++++++++
++++++++++++++++++++
++++  ++++++++++   +
++++  ++++++++++   +
++++  ++++++++++A  +
++++a ++++++++++   +
++++  ++++++++++   +
++++  ++++++++++0  +
++++  +++++++      +
++++  ++++++++     +
++++  ++++  ++++   +
++++   ++    ++++  +
++++         ++++  +
+++++        ++++  +
+++++  ++          +
+++++              +
+++++     +  +++   +
+++++   + +        +
++++++ +++++      ++
++++++++++++++++++++
