++++++++++++++++++++
++++++++++++++++++++
+++++++++++++++++  +
++++++++A          +
++++++++           +
+++++++++++++++++  +
+++++++++++++++++  +
+++++++++++++++++  +
+++++++++++++++++  +
++++++++++    a    +
++++++++++         +
++++++++++  ++     +
++++++++++  ++     +
+++  0             +
+++                +
+++  +++++++++     +
+++  +++++++++     +
++++++++++++++  +  +
+++++++++++++++++ ++
++++++++++++++++++++
