++++++++++++++++++++
++++++++++++++++++++
+++++              +
+++++       a      +
+++++    +         +
+++++ +  +  + +    +
+++++++  +  +      +
+++++++  +  ++    ++
+++++++     +    +++
+++++++ A+  ++   +++
+++++++  +  ++   +++
+++++++  +  +++  +++
+++++++  +  +++  +++
+++++++  +  ++++++++
+++++++  +  ++++++++
++++ ++  +  ++++++++
++++      0 ++++++++
++++       +++++++++
+++++  +++++++++++++
++++++++++++++++++++
