++++++++++++++++++++
++++++++++++++++++++
++++               +
+++            a   +
+++                +
+++          +     +
+++   +  +   +     +
+++  +++     + ++  +
+++  ++++      ++  +
+++  ++++      ++  +
+++  ++++  A+++++  +
+++++++++0 ++++++  +
+++++ +++  ++++++  +
+++++  ++  ++++++  +
+++++  +  +++++++  +
+++++  +  ++++++++++
+++++  +  ++++++++++
+++++    +++++++++++
++++++   +++++++++++
++++++++++++++++++++
