++++++++++++++++++++
++++++++++++++++++++
++  ++++    +++A   +
++  +  +    +      +
++      +   +      +
++    +  ++    ++  +
+++  ++  +++       +
+++++++  +++  + a  +
+++++++  +++  +++  +
+++++++  ++++++++  +
+++++++  +   +     +
+++++++      0     +
+++++++            +
+++++++  ++++++++  +
+++++++++++++++++  +
+++++++++++++++++  +
+++++++++++++++++  +
+++++++++++++++++  +
++++++++++++++++++++
++++++++++++++++++++
