++++++++++++++++++++
++++++++++++++++++++
++++++++++   +++   +
+++++   ++   +++   +
++++++   +   +++   +
+++++++     A++++  +
+++++++      ++++  +
+++++++   +a ++++ ++
++++++++     +++++++
+++++++++    +++++++
+++++++++    +++++++
+++++++++   0+++++++
+++++++++    ++  +++
+++++++++    ++    +
+++++++++          +
+++++++++  +       +
+++++++++          +
+++++++++          +
++++++++++        ++
++++++++++++++++++++
