++++++++++++++++++++
++++++++++++++++++++
+++++++++     ++  ++
++++++++      +    +
++++++++      +    +
++++++++       a+  +
+++++           +  +
+++++       +  ++  +
+++++A +        +  +
++ ++              +
++                 +
++         +      ++
+++++  +   +   +  ++
+++++  ++0 +   +++++
+++++ +++  +   +++++
++++++++++++    ++++
+++++++++++++   ++++
++++++++++++++++++++
++++++++++++++++++++
++++++++++++++++++++
