++++++++++++++++++++
++++++++++++++++++++
+++++++++++++++    +
+++++++++++++++    +
+++++++++  +++     +
++++++++           +
+++++++++          +
++++++++   ++      +
++++++++   ++      +
++++++++     a     +
++++++++        A  +
++++++++           +
+++++     ++    +  +
+++++     ++    +  +
+++++ ++++++       +
++++++++++++     +++
+++++++++++++   0+++
++++++++++++++     +
++++++++++++++++  ++
++++++++++++++++++++
