++++++++++++++++++++
++++++++++++++++++++
++++++             +
+++++++            +
++++++++++   0 ++  +
++++++++++A        +
++++++++++  +++    +
++++++++++  +++++  +
++++++++++  +++++  +
++++++++++  +++++  +
++++++++++  ++++   +
++++++++++  ++++   +
++++ +++++  ++++   +
++++  ++++  ++++   +
+++++  +++  ++++   +
+++++  + +  +++++  +
+++++  +  a ++++   +
+++++              +
++++++            ++
++++++++++++++++++++
