++++++++++++++++++++
++++++++++++++++++++
++++++++++++++++++++
+++  +++++++++++++++
+++  +++++++++++++++
+++  +++++++++++   +
+++  +++++++++++0  +
+++  +++++++++++   +
+++  +++++++++++   +
+++  +++++++++++   +
+++  ++  ++++++++  +
+++  +++ a  +      +
+++   ++    +      +
+++    +     A     +
+++    +           +
+++                +
+++      +++++     +
+++  +++++++++++   +
+++++++++++++++++ ++
++++++++++++++++++++
