++++++++++++++++++++
++++++++++++++++++++
+++++++            +
+++   0            +
++++          +++  +
+++++++       +++  +
+++++++++  +  +++  +
+++++++++  +   a+  +
++   ++++  ++      +
++    +  A ++++    +
++                 +
++ ++              +
+++++++++  ++      +
+++++++++++++      +
++++++++++++++     +
++++++++++++       +
+++++++++++++      +
+++++++++++++++++  +
++++++++++++++++++++
++++++++++++++++++++
