++++++++++++++++++++
++++++++++++++++++++
++++  +++++++++++  +
++++  +++++++++++  +
++++  a  +++ ++++  +
++ +      ++  +++  +
++   +++  ++  +++  +
++  ++++  ++  +++  +
++  ++++  ++  +++  +
++  ++++      +++  +
++            ++   +
+++   A           ++
++++++++++++       +
+++++++++++  0 +   +
+++++++++++    +   +
+++++++++++        +
++++++++++++       +
++++++++++++  +    +
++++++++++++++++  ++
++++++++++++++++++++
