++++++++++++++++++++
++++++++++++++++++++
+++++++++++++++++  +
+++++++++++++++++  +
+++++++++++++++++  +
++++++++  ++++  +  +
++++++++  +++  A   +
++++   +a ++++     +
++++   +   0 ++++  +
++++         ++++  +
++++               +
+++                +
++++               +
++++  ++++    +    +
++++  ++++++++++   +
++++ +++++++++++   +
+++++++++++++++    +
+++++++++++++++    +
++++++++++++++++  ++
++++++++++++++++++++
