++++++++++++++++++++
++++++++++++++++++++
++++++        +  +++
++++++           +++
++++++  a        +++
++++++           +++
+++      +        ++
++++     +         +
++++++++++  +++++  +
++++++++++  +++++  +
++++++++++  +++++  +
+++++  A    +++++  +
++++++             +
++  ++++++  0      +
+++  +++++++  +    +
+++  +++++++  ++   +
+++  +++++++  +++  +
+++          ++++  +
++++         ++++ ++
++++++++++++++++++++
