++++++++++++++++++++
++++++++++++++++++++
+++++++  +++      ++
++++       +       +
++++            +  +
+++++++  ++    ++  +
+++++    +++   ++  +
+++++   a+++  +++  +
+++   +  +++  +++  +
++++  +  +++       +
++++  +   +++  A   +
++++  +    +    +  +
++++   0+  ++   +  +
+++++      +++  +  +
+++++++    +++  +  +
+++++++    +++  +  +
+++++++    ++++    +
+++++++     ++++   +
++++++++   ++++++ ++
++++++++++++++++++++
