++++++++++++++++++++
++++++++++++++++++++
+++++++   +       ++
+++++++   +     0  +
+++++++       +++  +
+++++         +++  +
++++           ++  +
++++  +    ++      +
++++++ a           +
++++++             +
+++++    ++++  ++  +
+++++     +++++++  +
++        +++++++  +
++         ++++++  +
++  +++++  ++   +  +
++ ++++++  ++      +
+++++++++    A+    +
++++++++++    +    +
++++++++++++++++  ++
++++++++++++++++++++
