++++++++++++++++++++
++++++++++++++++++++
+++++++++A         +
+++++++++          +
+++++++++  +   +   +
+++++++++  +       +
+++++++++  ++      +
+++++++    +++     +
++++++++   +++     +
+++++++++  +++     +
+++++++++  +++  +  +
+++++++++  +++ ++  +
+++++++++  +++     +
+++++++++          +
+++++++++      +   +
+++++++++  a++++   +
+++++++++  0++++   +
+++++++++  +++++   +
++++++++++ ++++++ ++
++++++++++++++++++++
