++++++++++++++++++++
++++++++++++++++++++
++++++++ 0 a   +   +
++++++++       +  ++
++++++++       +  ++
++++++++          ++
++++++++A  +      ++
++++++ +++ +      ++
++++++  ++++   +   +
++++++     +   +   +
++++++         +   +
++++++  ++         +
++++++  +++        +
++++++  ++++       +
++++++        +++  +
+++++++       +++  +
+++++++++++++++++  +
+++++++++++++++++  +
++++++++++++++++++++
++++++++++++++++++++
