++++++++++++++++++++
++++++++++++++++++++
+++   +++++++++++  +
+++      ++++++++  +
+++       +++++++  +
++++  ++   ++++++  +
++++  +++   +++++  +
++++  ++++   ++++  +
++++  ++++         +
++++  +++++++      +
+++   +++++++  +0  +
+++    ++++++  +   +
++     ++++++ ++   +
++  a  ++          +
++  +  ++   A      +
+++ +        +++   +
++++++    +        +
++++++++++++++     +
+++++++++++++++++ ++
++++++++++++++++++++
