++++++++++++++++++++
++++++++++++++++++++
+++++++++++++  ++  +
++++ ++  +     ++  +
++++  +       +    +
++++  +            +
++++        +      +
+++++       +  A   +
++++++++    +      +
++++++++    + a    +
+++++++++  +++     +
++++++++        0  +
+++++              +
++++++   +++++++   +
++++++++++++++++   +
++++++++++++++++   +
++++++++++++ +++   +
++++++++++++       +
+++++++++++++     ++
++++++++++++++++++++
