++++++++++++++++++++
++++++++++++++++++++
+++++     +++++++  +
+++                +
+++   +0      A    +
+++  +++     ++++  +
++  ++++     +++   +
+++ ++++     ++++  +
++++++++     ++++  +
+++++++++    ++++  +
+++++++++    +++++++
+++++++++    +++++++
+++++++++    +++++++
+++++++++    +++++++
+++++++++    +++++++
+++++++      +++++++
+++++++     a +++  +
++++++++           +
++++++++++++      ++
++++++++++++++++++++
