++++++++++++++++++++
++++++++++++++++++++
+++++++++  +       +
+++++++++  +       +
+++++++++  +    +  +
+++++++++  +    +  +
+++++++++    +  +  +
+++++++++  a    +  +
+++++++++          +
++++++ ++          +
++++++  +  +       +
++++++  +  ++      +
++++++     +       +
++++++     +    +  +
++++++  +  +A +++  +
++++++     +0 +++  +
++++++        +++  +
++++++  +    ++++ ++
++++++++++++++++++++
++++++++++++++++++++
