++++++++++++++++++++
++++++++++++++++++++
+++++++++++  +     +
+++++++++++ 0      +
+++++++++++        +
+++++++++++  +  +  +
++++  +++      ++  +
+++++   +      ++  +
++++++    ++  +++  +
++++++   a++  +++  +
++  ++  ++++  +++  +
++  ++++++++       +
++  ++++++++       +
++  ++++++++  +    +
++  ++++++++  +    +
++   +++++++  +    +
+++  A             +
++++               +
+++++  +++++++++++++
++++++++++++++++++++
