++++++++++++++++++++
++++++++++++++++++++
++++++++           +
+++++++            +
++++++   +++   ++  +
+++++++   ++      ++
++ ++++   a  + A   +
++  +++      ++++  +
+++  ++  ++++++++  +
+++  ++  ++++++++  +
+++        ++++    +
++++  0     +++    +
+++++++++          +
+++++++++          +
+++++++++          +
+++++++++  +++     +
+++++++++ +++++++  +
++++++++++++++++++++
++++++++++++++++++++
++++++++++++++++++++
