++++++++++++++++++++
++++++++++++++++++++
+++++++  +++++++++++
+++++++ 0 ++++++++++
+++++++   ++++++++++
++ ++++   ++++++++++
++  +       ++++++++
++ A        +++   ++
+++   +     ++++   +
+++++++      ++++  +
+++++++  +    +++  +
+++++++  +  +      +
+++++++++++  +     +
+++++++++++  ++++  +
+++++++++++    a   +
+++++  ++++        +
++++++  ++++  +++  +
++++++             +
+++++++           ++
++++++++++++++++++++
