++++++++++++++++++++
++++++++++++++++++++
++ A+       ++++++++
++           +++++++
++   a +++   ++++  +
++     +++         +
+++0   +++         +
+++    +           +
++++         ++    +
+++++       +++    +
++++++++        +  +
++++++++        +  +
++++++++   ++++++  +
++++   +   ++++++  +
++++       ++++++  +
++++++             +
++++++             +
+++++++  +++++++   +
+++++++++++++++++ ++
++++++++++++++++++++
