++++++++++++++++++++
++++++++++++++++++++
+++            A   +
+++                +
+++  ++++++++++++  +
+++ ++++++++++++   +
++++++++++++++++   +
+++++++   a        +
+++++         0    +
++++++  ++      +  +
++++++++++++++  +  +
+++ ++++++  ++     +
+++  +++++  ++     +
+++  +++++  ++++   +
+++  +++++  ++++   +
+++   ++++  +++++ ++
+++    +++  ++++++++
+++        +++++++++
++++++     +++++++++
++++++++++++++++++++
