++++++++++++++++++++
++++++++++++++++++++
+++    +++++++0    +
+++     ++++++     +
+++  +  ++++++  ++++
+++  +   ++++    +++
++++             +++
+++++              +
+++++++   +        +
+++++++            +
+++++++            +
+++++++      +     +
++++        A++    +
++++  a +    ++++  +
+++     +    ++++ ++
++++   ++    +++++++
++++   ++    +++++++
++++  +++    +++++++
++++++++++  ++++++++
++++++++++++++++++++
