++++++++++++++++++++
++++++++++++++++++++
++++++++  0     ++++
+++++++         ++++
+++++++        +++++
+++++++     a  +++++
+++++++        +++++
+++++++        +++++
+++++++        +++++
++++++++ A +  ++++++
++++++        ++++++
+++++++       ++++++
+++++++++     ++++++
+++++++++     +++  +
++++++++++    + +  +
++++++++++    +    +
++++++++++    +    +
++++++++++         +
+++++++++++++  +  ++
++++++++++++++++++++
