++++++++++++++++++++
++++++++++++++++++++
+++++++   ++   +   +
+++++++   ++   +  ++
+++++  a     +++   +
++++++             +
++++++             +
++++++   +++++++   +
++++++   ++++++++  +
+++++++  +++  +++  +
+++++++ A+++   ++  +
+++++++  +++   ++  +
+++++++  ++    ++  +
++++++   +++ 0     +
+++++++ ++++       +
+++++++++++++++++  +
+++++++++++++++++  +
+++++++++++++++++  +
+++++++++++++++++ ++
++++++++++++++++++++
