++++++++++++++++++++
++++++++++++++++++++
+++++    ++++++++  +
++++     ++   +++  +
+++++ +  +         +
+++++++      +     +
+++ +++            +
+++ A+++    +      +
++++  ++++  +++++  +
++++  ++++  +++++  +
++++  ++++++++++   +
++++  ++++++++++   +
++++  ++++++++++   +
++++  ++++++++++  ++
++++  ++++++a     ++
++++  ++++++      ++
++++       0 ++    +
+++++        ++    +
+++++++++++++++++ ++
++++++++++++++++++++
