++++++++++++++++++++
++++++++++++++++++++
++++++   +++++    ++
++++              ++
++++ a          +  +
++++      ++++  +  +
++++         +     +
++++    +          +
++++  ++++++       +
+++  +++  +      +++
+++A +++  ++     +++
++++  ++  ++    ++++
++++  ++  +++   +  +
++++  ++  +++  ++  +
++++  ++ 0     ++  +
++++  ++  +    ++  +
++++  ++  +++     ++
++++      +++     ++
+++++     ++++ +++++
++++++++++++++++++++
