++++++++++++++++++++
++++++++++++++++++++
++  ++++++++++++++++
++  ++++++++++++++++
++  ++++++  ++++++++
++  +++++          +
++  +++++    a     +
++          +++    +
++          +++    +
++  +   ++  +++    +
++  +    +  +  A   +
+++      +       +++
++               +++
++       +       +++
++       ++++    +++
++ 0+       +    +++
++  +       +   ++++
++  +  ++++++   ++++
++++++ +++++++++++++
++++++++++++++++++++
